name,nodes,edges,density,time,result_set,result_w
SoA heuristic,20,15,0.039473684210526314,2.2399937734007835e-05,5,14
MMG,20,15,0.039473684210526314,9.650015272200108e-05,5,14
SoA heuristic,40,30,0.019230769230769232,2.9100105166435242e-05,10,58
MMG,40,30,0.019230769230769232,0.000228899996727705,10,58
SoA heuristic,100,75,0.007575757575757576,5.979998968541622e-05,25,300
MMG,100,75,0.007575757575757576,0.0009501997847110033,25,300
SoA heuristic,200,150,0.0037688442211055275,0.00011159991845488548,50,1265
MMG,200,150,0.0037688442211055275,0.003349199891090393,50,1265
SoA heuristic,400,300,0.0018796992481203006,0.00019450020045042038,100,5083
MMG,400,300,0.0018796992481203006,0.011823700042441487,100,5083
SoA heuristic,600,450,0.0012520868113522537,0.0003198001068085432,150,11235
MMG,600,450,0.0012520868113522537,0.02807660005055368,150,11235
SoA heuristic,1000,750,0.0007507507507507507,0.0006171001587063074,250,31166
MMG,1000,750,0.0007507507507507507,0.07605199981480837,250,31166
SoA heuristic,2000,1500,0.00037518759379689845,0.0011285999789834023,500,125188
MMG,2000,1500,0.00037518759379689845,0.29732659994624555,500,125188
SoA heuristic,4000,3000,0.00018754688672168043,0.0021115001291036606,1000,499926
MMG,4000,3000,0.00018754688672168043,1.1941751001868397,1000,499926
SoA heuristic,8000,6000,9.376172021502688e-05,0.005781699903309345,2000,2000786
MMG,8000,6000,9.376172021502688e-05,4.772231699898839,2000,2000786
SoA heuristic,20,15,0.039473684210526314,1.9999919459223747e-05,5,8
MMG,20,15,0.039473684210526314,9.749992750585079e-05,5,8
SoA heuristic,40,30,0.019230769230769232,3.2499898225069046e-05,10,48
MMG,40,30,0.019230769230769232,0.0002438998781144619,10,48
SoA heuristic,100,75,0.007575757575757576,6.0300109907984734e-05,25,299
MMG,100,75,0.007575757575757576,0.0010348998475819826,25,299
SoA heuristic,200,150,0.0037688442211055275,0.00011540018022060394,50,1252
MMG,200,150,0.0037688442211055275,0.003463099943473935,50,1252
SoA heuristic,400,300,0.0018796992481203006,0.0002117999829351902,100,4978
MMG,400,300,0.0018796992481203006,0.01282500009983778,100,4978
SoA heuristic,600,450,0.0012520868113522537,0.0003182000946253538,150,11226
MMG,600,450,0.0012520868113522537,0.027964500011876225,150,11226
SoA heuristic,1000,750,0.0007507507507507507,0.0005721000488847494,250,31191
MMG,1000,750,0.0007507507507507507,0.07535870000720024,250,31191
SoA heuristic,2000,1500,0.00037518759379689845,0.0011323001235723495,500,125154
MMG,2000,1500,0.00037518759379689845,0.2957264999859035,500,125154
SoA heuristic,4000,3000,0.00018754688672168043,0.0026344999205321074,1000,499781
MMG,4000,3000,0.00018754688672168043,1.191397099988535,1000,499781
SoA heuristic,8000,6000,9.376172021502688e-05,0.005891900043934584,2000,2000463
MMG,8000,6000,9.376172021502688e-05,4.871289799921215,2000,2000463
SoA heuristic,20,15,0.039473684210526314,2.1700048819184303e-05,5,14
MMG,20,15,0.039473684210526314,0.0001004999503493309,5,14
SoA heuristic,40,30,0.019230769230769232,2.9999995604157448e-05,10,47
MMG,40,30,0.019230769230769232,0.00024249986745417118,10,47
SoA heuristic,100,75,0.007575757575757576,5.8399979025125504e-05,25,314
MMG,100,75,0.007575757575757576,0.0009465999901294708,25,314
SoA heuristic,200,150,0.0037688442211055275,0.00011150003410875797,50,1250
MMG,200,150,0.0037688442211055275,0.0033506001345813274,50,1250
SoA heuristic,400,300,0.0018796992481203006,0.00021929992362856865,100,5052
MMG,400,300,0.0018796992481203006,0.012698800070211291,100,5052
SoA heuristic,600,450,0.0012520868113522537,0.0003035999834537506,150,11194
MMG,600,450,0.0012520868113522537,0.02819769992493093,150,11194
SoA heuristic,1000,750,0.0007507507507507507,0.0006029000505805016,250,31376
MMG,1000,750,0.0007507507507507507,0.0756326001137495,250,31376
SoA heuristic,2000,1500,0.00037518759379689845,0.0012483999598771334,500,124788
MMG,2000,1500,0.00037518759379689845,0.29657819983549416,500,124788
SoA heuristic,4000,3000,0.00018754688672168043,0.0022279999684542418,1000,499671
MMG,4000,3000,0.00018754688672168043,1.1897013001143932,1000,499671
SoA heuristic,8000,6000,9.376172021502688e-05,0.0053634000942111015,2000,2001121
MMG,8000,6000,9.376172021502688e-05,4.824961300007999,2000,2001121
SoA heuristic,20,15,0.039473684210526314,2.350006252527237e-05,5,13
MMG,20,15,0.039473684210526314,9.80000477284193e-05,5,13
SoA heuristic,40,30,0.019230769230769232,2.8399983420968056e-05,10,50
MMG,40,30,0.019230769230769232,0.00022289995104074478,10,50
SoA heuristic,100,75,0.007575757575757576,5.959998816251755e-05,25,300
MMG,100,75,0.007575757575757576,0.0009759999811649323,25,300
SoA heuristic,200,150,0.0037688442211055275,0.00010819989256560802,50,1239
MMG,200,150,0.0037688442211055275,0.0033221999183297157,50,1239
SoA heuristic,400,300,0.0018796992481203006,0.00021520000882446766,100,4980
MMG,400,300,0.0018796992481203006,0.01265549985691905,100,4980
SoA heuristic,600,450,0.0012520868113522537,0.00028680008836090565,150,11206
MMG,600,450,0.0012520868113522537,0.027055199956521392,150,11206
SoA heuristic,1000,750,0.0007507507507507507,0.000599999912083149,250,31303
MMG,1000,750,0.0007507507507507507,0.07649650005623698,250,31303
SoA heuristic,2000,1500,0.00037518759379689845,0.001120199915021658,500,125112
MMG,2000,1500,0.00037518759379689845,0.3008300999645144,500,125112
SoA heuristic,4000,3000,0.00018754688672168043,0.0021666998509317636,1000,500515
MMG,4000,3000,0.00018754688672168043,1.2031717000063509,1000,500515
SoA heuristic,8000,6000,9.376172021502688e-05,0.007178099825978279,2000,2001028
MMG,8000,6000,9.376172021502688e-05,6.715130599914119,2000,2001028
SoA heuristic,20,15,0.039473684210526314,4.039984196424484e-05,5,15
MMG,20,15,0.039473684210526314,0.0001984999980777502,5,15
SoA heuristic,40,30,0.019230769230769232,3.620004281401634e-05,10,45
MMG,40,30,0.019230769230769232,0.00022620009258389473,10,45
SoA heuristic,100,75,0.007575757575757576,5.5900076404213905e-05,25,319
MMG,100,75,0.007575757575757576,0.0009272999595850706,25,319
SoA heuristic,200,150,0.0037688442211055275,9.569991379976273e-05,50,1253
MMG,200,150,0.0037688442211055275,0.0030763999093323946,50,1253
SoA heuristic,400,300,0.0018796992481203006,0.00019789999350905418,100,5015
MMG,400,300,0.0018796992481203006,0.014867999823763967,100,5015
SoA heuristic,600,450,0.0012520868113522537,0.0002842000685632229,150,11206
MMG,600,450,0.0012520868113522537,0.025708999950438738,150,11206
SoA heuristic,1000,750,0.0007507507507507507,0.0010961999651044607,250,31208
MMG,1000,750,0.0007507507507507507,0.10560549981892109,250,31208
SoA heuristic,2000,1500,0.00037518759379689845,0.0017649000510573387,500,125169
MMG,2000,1500,0.00037518759379689845,0.4111343000549823,500,125169
SoA heuristic,4000,3000,0.00018754688672168043,0.0028430998791009188,1000,500616
MMG,4000,3000,0.00018754688672168043,1.5200878998730332,1000,500616
SoA heuristic,8000,6000,9.376172021502688e-05,0.0153481001034379,2000,1999411
MMG,8000,6000,9.376172021502688e-05,7.206193800084293,2000,1999411
SoA heuristic,20,15,0.039473684210526314,2.510007470846176e-05,5,15
MMG,20,15,0.039473684210526314,0.00013539986684918404,5,15
SoA heuristic,40,30,0.019230769230769232,3.2499898225069046e-05,10,43
MMG,40,30,0.019230769230769232,0.0002391999587416649,10,43
SoA heuristic,100,75,0.007575757575757576,7.08999577909708e-05,25,329
MMG,100,75,0.007575757575757576,0.0009961000178009272,25,329
SoA heuristic,200,150,0.0037688442211055275,0.00010359985753893852,50,1260
MMG,200,150,0.0037688442211055275,0.003265699837356806,50,1260
SoA heuristic,400,300,0.0018796992481203006,0.0002050998155027628,100,4970
MMG,400,300,0.0018796992481203006,0.012419299921020865,100,4970
SoA heuristic,600,450,0.0012520868113522537,0.0003059001173824072,150,11116
MMG,600,450,0.0012520868113522537,0.02740479982458055,150,11116
SoA heuristic,1000,750,0.0007507507507507507,0.0006094998680055141,250,31407
MMG,1000,750,0.0007507507507507507,0.0746961000841111,250,31407
SoA heuristic,2000,1500,0.00037518759379689845,0.0010176000650972128,500,124816
MMG,2000,1500,0.00037518759379689845,0.28633909998461604,500,124816
SoA heuristic,4000,3000,0.00018754688672168043,0.0025893000420182943,1000,499207
MMG,4000,3000,0.00018754688672168043,1.1710741000715643,1000,499207
SoA heuristic,8000,6000,9.376172021502688e-05,0.004571200115606189,2000,1999869
MMG,8000,6000,9.376172021502688e-05,4.734259799821302,2000,1999869
SoA heuristic,20,15,0.039473684210526314,2.2300053387880325e-05,5,9
MMG,20,15,0.039473684210526314,9.869993664324284e-05,5,9
SoA heuristic,40,30,0.019230769230769232,3.200001083314419e-05,10,53
MMG,40,30,0.019230769230769232,0.00023770006373524666,10,53
SoA heuristic,100,75,0.007575757575757576,6.589991971850395e-05,25,313
MMG,100,75,0.007575757575757576,0.0009949998930096626,25,313
SoA heuristic,200,150,0.0037688442211055275,0.000107599887996912,50,1279
MMG,200,150,0.0037688442211055275,0.0030670000705868006,50,1279
SoA heuristic,400,300,0.0018796992481203006,0.000206800177693367,100,5111
MMG,400,300,0.0018796992481203006,0.012375399935990572,100,5111
SoA heuristic,600,450,0.0012520868113522537,0.0003146999515593052,150,11178
MMG,600,450,0.0012520868113522537,0.02790859993547201,150,11178
SoA heuristic,1000,750,0.0007507507507507507,0.0006124998908489943,250,31122
MMG,1000,750,0.0007507507507507507,0.07539639994502068,250,31122
SoA heuristic,2000,1500,0.00037518759379689845,0.0011093998327851295,500,125484
MMG,2000,1500,0.00037518759379689845,0.2950443997979164,500,125484
SoA heuristic,4000,3000,0.00018754688672168043,0.0020941998809576035,1000,500404
MMG,4000,3000,0.00018754688672168043,1.187861799960956,1000,500404
SoA heuristic,8000,6000,9.376172021502688e-05,0.005140000022947788,2000,1998318
MMG,8000,6000,9.376172021502688e-05,4.78553059999831,2000,1998318
SoA heuristic,20,15,0.039473684210526314,2.119992859661579e-05,5,12
MMG,20,15,0.039473684210526314,9.63001511991024e-05,5,12
SoA heuristic,40,30,0.019230769230769232,4.9900030717253685e-05,10,55
MMG,40,30,0.019230769230769232,0.00023160013370215893,10,55
SoA heuristic,100,75,0.007575757575757576,5.819997750222683e-05,25,309
MMG,100,75,0.007575757575757576,0.0009435000829398632,25,309
SoA heuristic,200,150,0.0037688442211055275,0.00010549998842179775,50,1224
MMG,200,150,0.0037688442211055275,0.0033360999077558517,50,1224
SoA heuristic,400,300,0.0018796992481203006,0.00021130009554326534,100,5037
MMG,400,300,0.0018796992481203006,0.012411900097504258,100,5037
SoA heuristic,600,450,0.0012520868113522537,0.0003005999606102705,150,11312
MMG,600,450,0.0012520868113522537,0.027652000077068806,150,11312
SoA heuristic,1000,750,0.0007507507507507507,0.0005884000565856695,250,31383
MMG,1000,750,0.0007507507507507507,0.07511739991605282,250,31383
SoA heuristic,2000,1500,0.00037518759379689845,0.0013021999038755894,500,125610
MMG,2000,1500,0.00037518759379689845,0.29578129993751645,500,125610
SoA heuristic,4000,3000,0.00018754688672168043,0.0027199999894946814,1000,500006
MMG,4000,3000,0.00018754688672168043,1.1954094001557678,1000,500006
SoA heuristic,8000,6000,9.376172021502688e-05,0.005629499908536673,2000,2000613
MMG,8000,6000,9.376172021502688e-05,4.95377209992148,2000,2000613
SoA heuristic,20,15,0.039473684210526314,2.4399952962994576e-05,5,10
MMG,20,15,0.039473684210526314,0.00011100014671683311,5,10
SoA heuristic,40,30,0.019230769230769232,3.110012039542198e-05,10,50
MMG,40,30,0.019230769230769232,0.00023459992371499538,10,50
SoA heuristic,100,75,0.007575757575757576,5.970010533928871e-05,25,309
MMG,100,75,0.007575757575757576,0.0009783001150935888,25,309
SoA heuristic,200,150,0.0037688442211055275,0.00010979990474879742,50,1257
MMG,200,150,0.0037688442211055275,0.003238900098949671,50,1257
SoA heuristic,400,300,0.0018796992481203006,0.00021079997532069683,100,4927
MMG,400,300,0.0018796992481203006,0.012618399923667312,100,4927
SoA heuristic,600,450,0.0012520868113522537,0.00030960002914071083,150,11379
MMG,600,450,0.0012520868113522537,0.027724600164219737,150,11379
SoA heuristic,1000,750,0.0007507507507507507,0.0005694001447409391,250,31080
MMG,1000,750,0.0007507507507507507,0.07555900001898408,250,31080
SoA heuristic,2000,1500,0.00037518759379689845,0.0011342000216245651,500,125161
MMG,2000,1500,0.00037518759379689845,0.28624660009518266,500,125161
SoA heuristic,4000,3000,0.00018754688672168043,0.0025309999473392963,1000,500383
MMG,4000,3000,0.00018754688672168043,1.1913863001391292,1000,500383
SoA heuristic,8000,6000,9.376172021502688e-05,0.004733100067824125,2000,1999885
MMG,8000,6000,9.376172021502688e-05,4.745807700091973,2000,1999885
SoA heuristic,20,15,0.039473684210526314,2.3900065571069717e-05,5,10
MMG,20,15,0.039473684210526314,0.00010020006448030472,5,10
SoA heuristic,40,30,0.019230769230769232,3.060000017285347e-05,10,49
MMG,40,30,0.019230769230769232,0.00023610005155205727,10,49
SoA heuristic,100,75,0.007575757575757576,5.660019814968109e-05,25,307
MMG,100,75,0.007575757575757576,0.0009695999324321747,25,307
SoA heuristic,200,150,0.0037688442211055275,0.00010649999603629112,50,1203
MMG,200,150,0.0037688442211055275,0.0033001999836415052,50,1203
SoA heuristic,400,300,0.0018796992481203006,0.00021130009554326534,100,5064
MMG,400,300,0.0018796992481203006,0.012388700153678656,100,5064
SoA heuristic,600,450,0.0012520868113522537,0.00031720008701086044,150,11208
MMG,600,450,0.0012520868113522537,0.02779909991659224,150,11208
SoA heuristic,1000,750,0.0007507507507507507,0.0005951998755335808,250,31212
MMG,1000,750,0.0007507507507507507,0.07555399998091161,250,31212
SoA heuristic,2000,1500,0.00037518759379689845,0.0012394001241773367,500,124571
MMG,2000,1500,0.00037518759379689845,0.2961153001524508,500,124571
SoA heuristic,4000,3000,0.00018754688672168043,0.002330200048163533,1000,500344
MMG,4000,3000,0.00018754688672168043,1.1788180998992175,1000,500344
SoA heuristic,8000,6000,9.376172021502688e-05,0.00462420005351305,2000,1999880
MMG,8000,6000,9.376172021502688e-05,4.835067000007257,2000,1999880
SoA heuristic,20,15,0.039473684210526314,2.0700041204690933e-05,5,14
MMG,20,15,0.039473684210526314,9.400001727044582e-05,5,14
SoA heuristic,40,30,0.019230769230769232,3.2800016924738884e-05,10,55
MMG,40,30,0.019230769230769232,0.0002668001689016819,10,55
SoA heuristic,100,75,0.007575757575757576,7.870001718401909e-05,25,324
MMG,100,75,0.007575757575757576,0.0008922999259084463,25,324
SoA heuristic,200,150,0.0037688442211055275,9.660003706812859e-05,50,1291
MMG,200,150,0.0037688442211055275,0.0030642999336123466,50,1291
SoA heuristic,400,300,0.0018796992481203006,0.00019349996000528336,100,5013
MMG,400,300,0.0018796992481203006,0.014374700142070651,100,5013
SoA heuristic,600,450,0.0012520868113522537,0.0008995998650789261,150,11265
MMG,600,450,0.0012520868113522537,0.059605199843645096,150,11265
SoA heuristic,1000,750,0.0007507507507507507,0.0007404000498354435,250,31342
MMG,1000,750,0.0007507507507507507,0.1092272000387311,250,31342
SoA heuristic,2000,1500,0.00037518759379689845,0.0012246998958289623,500,124957
MMG,2000,1500,0.00037518759379689845,0.36399780004285276,500,124957
SoA heuristic,4000,3000,0.00018754688672168043,0.0020735999569296837,1000,499613
MMG,4000,3000,0.00018754688672168043,1.3176508999895304,1000,499613
SoA heuristic,8000,6000,9.376172021502688e-05,0.01011050003580749,2000,1999433
MMG,8000,6000,9.376172021502688e-05,6.494467499898747,2000,1999433
SoA heuristic,20,15,0.039473684210526314,8.650007657706738e-05,5,12
MMG,20,15,0.039473684210526314,0.0004774997942149639,5,12
SoA heuristic,40,30,0.019230769230769232,2.759997732937336e-05,10,52
MMG,40,30,0.019230769230769232,0.00021980004385113716,10,52
SoA heuristic,100,75,0.007575757575757576,5.529983900487423e-05,25,293
MMG,100,75,0.007575757575757576,0.000986000057309866,25,293
SoA heuristic,200,150,0.0037688442211055275,0.00028449995443224907,50,1311
MMG,200,150,0.0037688442211055275,0.008837699890136719,50,1311
SoA heuristic,400,300,0.0018796992481203006,0.00033769989386200905,100,4981
MMG,400,300,0.0018796992481203006,0.01939659984782338,100,4981
SoA heuristic,600,450,0.0012520868113522537,0.00037470017559826374,150,11245
MMG,600,450,0.0012520868113522537,0.026070200139656663,150,11245
SoA heuristic,1000,750,0.0007507507507507507,0.001528100110590458,250,31082
MMG,1000,750,0.0007507507507507507,0.1343753000255674,250,31082
SoA heuristic,2000,1500,0.00037518759379689845,0.001023799879476428,500,125235
MMG,2000,1500,0.00037518759379689845,0.579821600113064,500,125235
SoA heuristic,4000,3000,0.00018754688672168043,0.0020372001454234123,1000,500118
MMG,4000,3000,0.00018754688672168043,1.8093129999469966,1000,500118
SoA heuristic,8000,6000,9.376172021502688e-05,0.00584469991736114,2000,1998645
MMG,8000,6000,9.376172021502688e-05,6.813734499970451,2000,1998645
SoA heuristic,20,15,0.039473684210526314,2.140016295015812e-05,5,11
MMG,20,15,0.039473684210526314,9.96999442577362e-05,5,11
SoA heuristic,40,30,0.019230769230769232,2.969987690448761e-05,10,45
MMG,40,30,0.019230769230769232,0.00022849999368190765,10,45
SoA heuristic,100,75,0.007575757575757576,5.770009011030197e-05,25,316
MMG,100,75,0.007575757575757576,0.00161540019325912,25,316
SoA heuristic,200,150,0.0037688442211055275,0.00010429997928440571,50,1237
MMG,200,150,0.0037688442211055275,0.003564799902960658,50,1237
SoA heuristic,400,300,0.0018796992481203006,0.00019329995848238468,100,5072
MMG,400,300,0.0018796992481203006,0.012116200057789683,100,5072
SoA heuristic,600,450,0.0012520868113522537,0.0003417001571506262,150,11204
MMG,600,450,0.0012520868113522537,0.02685249992646277,150,11204
SoA heuristic,1000,750,0.0007507507507507507,0.0006073000840842724,250,31266
MMG,1000,750,0.0007507507507507507,0.1012049000710249,250,31266
SoA heuristic,2000,1500,0.00037518759379689845,0.001069999998435378,500,124657
MMG,2000,1500,0.00037518759379689845,0.4483014999423176,500,124657
SoA heuristic,4000,3000,0.00018754688672168043,0.002256500069051981,1000,500282
MMG,4000,3000,0.00018754688672168043,1.473722199909389,1000,500282
SoA heuristic,8000,6000,9.376172021502688e-05,0.004601299995556474,2000,1999844
MMG,8000,6000,9.376172021502688e-05,7.0590886999852955,2000,1999844
SoA heuristic,20,15,0.039473684210526314,2.2799940779805183e-05,5,14
MMG,20,15,0.039473684210526314,0.00010200007818639278,5,14
SoA heuristic,40,30,0.019230769230769232,2.8999987989664078e-05,10,53
MMG,40,30,0.019230769230769232,0.00023610005155205727,10,53
SoA heuristic,100,75,0.007575757575757576,6.0399994254112244e-05,25,305
MMG,100,75,0.007575757575757576,0.0009877998381853104,25,305
SoA heuristic,200,150,0.0037688442211055275,0.00011450005695223808,50,1238
MMG,200,150,0.0037688442211055275,0.0034364000894129276,50,1238
SoA heuristic,400,300,0.0018796992481203006,0.0002172000240534544,100,5045
MMG,400,300,0.0018796992481203006,0.015473200008273125,100,5045
SoA heuristic,600,450,0.0012520868113522537,0.00032650004141032696,150,11361
MMG,600,450,0.0012520868113522537,0.03443919983692467,150,11361
SoA heuristic,1000,750,0.0007507507507507507,0.0011163000017404556,250,31364
MMG,1000,750,0.0007507507507507507,0.12183590000495315,250,31364
SoA heuristic,2000,1500,0.00037518759379689845,0.0014944002032279968,500,124394
MMG,2000,1500,0.00037518759379689845,0.39885049988515675,500,124394
SoA heuristic,4000,3000,0.00018754688672168043,0.0026326999068260193,1000,500343
MMG,4000,3000,0.00018754688672168043,1.7380620997864753,1000,500343
SoA heuristic,8000,6000,9.376172021502688e-05,0.005508800037205219,2000,1999196
MMG,8000,6000,9.376172021502688e-05,6.577826099935919,2000,1999196
SoA heuristic,20,15,0.039473684210526314,3.96000687032938e-05,5,14
MMG,20,15,0.039473684210526314,0.00015150010585784912,5,14
SoA heuristic,40,30,0.019230769230769232,2.6799971237778664e-05,10,48
MMG,40,30,0.019230769230769232,0.00022070016711950302,10,48
SoA heuristic,100,75,0.007575757575757576,5.6999968364834785e-05,25,298
MMG,100,75,0.007575757575757576,0.00091559998691082,25,298
SoA heuristic,200,150,0.0037688442211055275,0.00010280008427798748,50,1289
MMG,200,150,0.0037688442211055275,0.0032210000790655613,50,1289
SoA heuristic,400,300,0.0018796992481203006,0.00019689998589456081,100,5067
MMG,400,300,0.0018796992481203006,0.01157859992235899,100,5067
SoA heuristic,600,450,0.0012520868113522537,0.0002807001583278179,150,11346
MMG,600,450,0.0012520868113522537,0.028604499995708466,150,11346
SoA heuristic,1000,750,0.0007507507507507507,0.0008781000506132841,250,31076
MMG,1000,750,0.0007507507507507507,0.09828849998302758,250,31076
SoA heuristic,2000,1500,0.00037518759379689845,0.0026249000802636147,500,124940
MMG,2000,1500,0.00037518759379689845,0.367270499933511,500,124940
SoA heuristic,4000,3000,0.00018754688672168043,0.0024067999329417944,1000,500037
MMG,4000,3000,0.00018754688672168043,1.7009360999800265,1000,500037
SoA heuristic,8000,6000,9.376172021502688e-05,0.005830500042065978,2000,2000917
MMG,8000,6000,9.376172021502688e-05,6.355350699974224,2000,2000917
SoA heuristic,20,15,0.039473684210526314,4.75000124424696e-05,5,10
MMG,20,15,0.039473684210526314,0.0001830998808145523,5,10
SoA heuristic,40,30,0.019230769230769232,2.95999925583601e-05,10,51
MMG,40,30,0.019230769230769232,0.0002296001184731722,10,51
SoA heuristic,100,75,0.007575757575757576,5.829986184835434e-05,25,301
MMG,100,75,0.007575757575757576,0.0009004001040011644,25,301
SoA heuristic,200,150,0.0037688442211055275,0.00011439993977546692,50,1242
MMG,200,150,0.0037688442211055275,0.006601299857720733,50,1242
SoA heuristic,400,300,0.0018796992481203006,0.0007364999037235975,100,5015
MMG,400,300,0.0018796992481203006,0.014282000018283725,100,5015
SoA heuristic,600,450,0.0012520868113522537,0.0002872999757528305,150,11185
MMG,600,450,0.0012520868113522537,0.04508870001882315,150,11185
SoA heuristic,1000,750,0.0007507507507507507,0.0005489001050591469,250,31146
MMG,1000,750,0.0007507507507507507,0.11773199983872473,250,31146
SoA heuristic,2000,1500,0.00037518759379689845,0.0010512999724596739,500,124697
MMG,2000,1500,0.00037518759379689845,0.3806243999861181,500,124697
SoA heuristic,4000,3000,0.00018754688672168043,0.00200640014372766,1000,499766
MMG,4000,3000,0.00018754688672168043,1.969641099916771,1000,499766
SoA heuristic,8000,6000,9.376172021502688e-05,0.00460029998794198,2000,2002051
MMG,8000,6000,9.376172021502688e-05,6.732097400119528,2000,2002051
SoA heuristic,20,15,0.039473684210526314,5.3099822252988815e-05,5,13
MMG,20,15,0.039473684210526314,0.0002554000820964575,5,13
SoA heuristic,40,30,0.019230769230769232,2.8899870812892914e-05,10,64
MMG,40,30,0.019230769230769232,0.00022569997236132622,10,64
SoA heuristic,100,75,0.007575757575757576,5.430006422102451e-05,25,315
MMG,100,75,0.007575757575757576,0.0009079000446945429,25,315
SoA heuristic,200,150,0.0037688442211055275,0.00010020006448030472,50,1245
MMG,200,150,0.0037688442211055275,0.004670600173994899,50,1245
SoA heuristic,400,300,0.0018796992481203006,0.00042479997500777245,100,5076
MMG,400,300,0.0018796992481203006,0.017141300020739436,100,5076
SoA heuristic,600,450,0.0012520868113522537,0.0010411001276224852,150,11322
MMG,600,450,0.0012520868113522537,0.03575560008175671,150,11322
SoA heuristic,1000,750,0.0007507507507507507,0.0005453000776469707,250,31179
MMG,1000,750,0.0007507507507507507,0.11696989997290075,250,31179
SoA heuristic,2000,1500,0.00037518759379689845,0.001083799870684743,500,124966
MMG,2000,1500,0.00037518759379689845,0.39079910004511476,500,124966
SoA heuristic,4000,3000,0.00018754688672168043,0.002314399927854538,1000,499274
MMG,4000,3000,0.00018754688672168043,1.688243400072679,1000,499274
SoA heuristic,8000,6000,9.376172021502688e-05,0.005081099923700094,2000,2000574
MMG,8000,6000,9.376172021502688e-05,6.985841199988499,2000,2000574
SoA heuristic,20,15,0.039473684210526314,2.119992859661579e-05,5,11
MMG,20,15,0.039473684210526314,9.229988791048527e-05,5,11
SoA heuristic,40,30,0.019230769230769232,2.859998494386673e-05,10,56
MMG,40,30,0.019230769230769232,0.0002234999556094408,10,56
SoA heuristic,100,75,0.007575757575757576,7.750000804662704e-05,25,328
MMG,100,75,0.007575757575757576,0.001056100009009242,25,328
SoA heuristic,200,150,0.0037688442211055275,0.00011450005695223808,50,1300
MMG,200,150,0.0037688442211055275,0.0036861998960375786,50,1300
SoA heuristic,400,300,0.0018796992481203006,0.00023830006830394268,100,5091
MMG,400,300,0.0018796992481203006,0.021977199940010905,100,5091
SoA heuristic,600,450,0.0012520868113522537,0.0003479002043604851,150,11341
MMG,600,450,0.0012520868113522537,0.06357719982042909,150,11341
SoA heuristic,1000,750,0.0007507507507507507,0.0005847001448273659,250,31379
MMG,1000,750,0.0007507507507507507,0.1078953999094665,250,31379
SoA heuristic,2000,1500,0.00037518759379689845,0.0011551000643521547,500,125545
MMG,2000,1500,0.00037518759379689845,0.45580610004253685,500,125545
SoA heuristic,4000,3000,0.00018754688672168043,0.006920100189745426,1000,499743
MMG,4000,3000,0.00018754688672168043,1.7814748000819236,1000,499743
SoA heuristic,8000,6000,9.376172021502688e-05,0.0063436999917030334,2000,1999435
MMG,8000,6000,9.376172021502688e-05,6.835376899922267,2000,1999435
SoA heuristic,20,15,0.039473684210526314,2.1700048819184303e-05,5,8
MMG,20,15,0.039473684210526314,9.560002945363522e-05,5,8
SoA heuristic,40,30,0.019230769230769232,2.9199989512562752e-05,10,47
MMG,40,30,0.019230769230769232,0.00022289995104074478,10,47
SoA heuristic,100,75,0.007575757575757576,0.00015409989282488823,25,324
MMG,100,75,0.007575757575757576,0.0026480001397430897,25,324
SoA heuristic,200,150,0.0037688442211055275,0.0002747001126408577,50,1304
MMG,200,150,0.0037688442211055275,0.00654580001719296,50,1304
SoA heuristic,400,300,0.0018796992481203006,0.00019180006347596645,100,5023
MMG,400,300,0.0018796992481203006,0.026610399829223752,100,5023
SoA heuristic,600,450,0.0012520868113522537,0.0002787001430988312,150,11184
MMG,600,450,0.0012520868113522537,0.04499630001373589,150,11184
SoA heuristic,1000,750,0.0007507507507507507,0.0005864000413566828,250,31413
MMG,1000,750,0.0007507507507507507,0.10258030006662011,250,31413
SoA heuristic,2000,1500,0.00037518759379689845,0.0021198999602347612,500,125054
MMG,2000,1500,0.00037518759379689845,0.38436520006507635,500,125054
SoA heuristic,4000,3000,0.00018754688672168043,0.0030248998664319515,1000,500285
MMG,4000,3000,0.00018754688672168043,1.6223137001506984,1000,500285
SoA heuristic,8000,6000,9.376172021502688e-05,0.004773000022396445,2000,1998861
MMG,8000,6000,9.376172021502688e-05,6.362236900022253,2000,1998861
SoA heuristic,20,15,0.039473684210526314,4.7900015488266945e-05,5,8
MMG,20,15,0.039473684210526314,0.0002267998643219471,5,8
SoA heuristic,40,30,0.019230769230769232,0.00010840012691915035,10,49
MMG,40,30,0.019230769230769232,0.0010108998976647854,10,49
SoA heuristic,100,75,0.007575757575757576,5.579995922744274e-05,25,328
MMG,100,75,0.007575757575757576,0.0015404000878334045,25,328
SoA heuristic,200,150,0.0037688442211055275,0.00014999997802078724,50,1234
MMG,200,150,0.0037688442211055275,0.00445530004799366,50,1234
SoA heuristic,400,300,0.0018796992481203006,0.0005393000319600105,100,4934
MMG,400,300,0.0018796992481203006,0.01992579991929233,100,4934
SoA heuristic,600,450,0.0012520868113522537,0.0007939999923110008,150,11254
MMG,600,450,0.0012520868113522537,0.03874629992060363,150,11254
SoA heuristic,1000,750,0.0007507507507507507,0.000761799979954958,250,31148
MMG,1000,750,0.0007507507507507507,0.10518840001896024,250,31148
SoA heuristic,2000,1500,0.00037518759379689845,0.0015910998918116093,500,125286
MMG,2000,1500,0.00037518759379689845,0.4683770998381078,500,125286
SoA heuristic,4000,3000,0.00018754688672168043,0.0023870000150054693,1000,500096
MMG,4000,3000,0.00018754688672168043,1.7738215001299977,1000,500096
SoA heuristic,8000,6000,9.376172021502688e-05,0.005171200027689338,2000,2000045
MMG,8000,6000,9.376172021502688e-05,7.0168992998078465,2000,2000045
SoA heuristic,20,15,0.039473684210526314,1.9800150766968727e-05,5,6
MMG,20,15,0.039473684210526314,9.530014358460903e-05,5,6
SoA heuristic,40,30,0.019230769230769232,4.600011743605137e-05,10,46
MMG,40,30,0.019230769230769232,0.00028909998945891857,10,46
SoA heuristic,100,75,0.007575757575757576,7.189996540546417e-05,25,299
MMG,100,75,0.007575757575757576,0.0026992999482899904,25,299
SoA heuristic,200,150,0.0037688442211055275,9.990017861127853e-05,50,1238
MMG,200,150,0.0037688442211055275,0.003109399927780032,50,1238
SoA heuristic,400,300,0.0018796992481203006,0.0001906000543385744,100,5003
MMG,400,300,0.0018796992481203006,0.011359600117430091,100,5003
SoA heuristic,600,450,0.0012520868113522537,0.00028130016289651394,150,11206
MMG,600,450,0.0012520868113522537,0.03766250004991889,150,11206
SoA heuristic,1000,750,0.0007507507507507507,0.0005226999055594206,250,31335
MMG,1000,750,0.0007507507507507507,0.10630119987763464,250,31335
SoA heuristic,2000,1500,0.00037518759379689845,0.0010522999800741673,500,124744
MMG,2000,1500,0.00037518759379689845,0.4481331999413669,500,124744
SoA heuristic,4000,3000,0.00018754688672168043,0.0025477998424321413,1000,500608
MMG,4000,3000,0.00018754688672168043,1.6409209999255836,1000,500608
SoA heuristic,8000,6000,9.376172021502688e-05,0.01246060011908412,2000,1999927
MMG,8000,6000,9.376172021502688e-05,6.7166619000490755,2000,1999927
SoA heuristic,20,15,0.039473684210526314,2.340017817914486e-05,5,16
MMG,20,15,0.039473684210526314,0.0001151000615209341,5,16
SoA heuristic,40,30,0.019230769230769232,2.9899878427386284e-05,10,49
MMG,40,30,0.019230769230769232,0.00023990008048713207,10,49
SoA heuristic,100,75,0.007575757575757576,5.810009315609932e-05,25,313
MMG,100,75,0.007575757575757576,0.0009304999839514494,25,313
SoA heuristic,200,150,0.0037688442211055275,0.00010859989561140537,50,1263
MMG,200,150,0.0037688442211055275,0.0031077000312507153,50,1263
SoA heuristic,400,300,0.0018796992481203006,0.00020450004376471043,100,5015
MMG,400,300,0.0018796992481203006,0.012300600064918399,100,5015
SoA heuristic,600,450,0.0012520868113522537,0.0002891998738050461,150,11357
MMG,600,450,0.0012520868113522537,0.027087399968877435,150,11357
SoA heuristic,1000,750,0.0007507507507507507,0.0005755999591201544,250,31251
MMG,1000,750,0.0007507507507507507,0.07535149995237589,250,31251
SoA heuristic,2000,1500,0.00037518759379689845,0.0012609001714736223,500,124876
MMG,2000,1500,0.00037518759379689845,0.2929239999502897,500,124876
SoA heuristic,4000,3000,0.00018754688672168043,0.0028246999718248844,1000,499792
MMG,4000,3000,0.00018754688672168043,1.1802360999863595,1000,499792
SoA heuristic,8000,6000,9.376172021502688e-05,0.005180600099265575,2000,1999866
MMG,8000,6000,9.376172021502688e-05,4.738975499989465,2000,1999866
SoA heuristic,20,15,0.039473684210526314,2.41999514400959e-05,5,14
MMG,20,15,0.039473684210526314,0.0001034000888466835,5,14
SoA heuristic,40,30,0.019230769230769232,3.1299889087677e-05,10,51
MMG,40,30,0.019230769230769232,0.0002682001795619726,10,51
SoA heuristic,100,75,0.007575757575757576,6.019999273121357e-05,25,332
MMG,100,75,0.007575757575757576,0.0010478999465703964,25,332
SoA heuristic,200,150,0.0037688442211055275,0.000112100038677454,50,1218
MMG,200,150,0.0037688442211055275,0.0034713998902589083,50,1218
SoA heuristic,400,300,0.0018796992481203006,0.00021569989621639252,100,4959
MMG,400,300,0.0018796992481203006,0.012736400123685598,100,4959
SoA heuristic,600,450,0.0012520868113522537,0.00031809997744858265,150,11157
MMG,600,450,0.0012520868113522537,0.027818799950182438,150,11157
SoA heuristic,1000,750,0.0007507507507507507,0.0005395000334829092,250,31215
MMG,1000,750,0.0007507507507507507,0.07273770007304847,250,31215
SoA heuristic,2000,1500,0.00037518759379689845,0.0011301001068204641,500,124792
MMG,2000,1500,0.00037518759379689845,0.29572820011526346,500,124792
SoA heuristic,4000,3000,0.00018754688672168043,0.0025224999990314245,1000,499047
MMG,4000,3000,0.00018754688672168043,1.19787220004946,1000,499047
SoA heuristic,8000,6000,9.376172021502688e-05,0.005592299858108163,2000,2000720
MMG,8000,6000,9.376172021502688e-05,4.68464529979974,2000,2000720
SoA heuristic,20,15,0.039473684210526314,2.159993164241314e-05,5,12
MMG,20,15,0.039473684210526314,0.00010220007970929146,5,12
SoA heuristic,40,30,0.019230769230769232,3.1899893656373024e-05,10,52
MMG,40,30,0.019230769230769232,0.00023669982329010963,10,52
SoA heuristic,100,75,0.007575757575757576,7.289997301995754e-05,25,303
MMG,100,75,0.007575757575757576,0.001032999949529767,25,303
SoA heuristic,200,150,0.0037688442211055275,0.00011799996718764305,50,1236
MMG,200,150,0.0037688442211055275,0.0034630000591278076,50,1236
SoA heuristic,400,300,0.0018796992481203006,0.00020830007269978523,100,5004
MMG,400,300,0.0018796992481203006,0.011580199934542179,100,5004
SoA heuristic,600,450,0.0012520868113522537,0.0003087997902184725,150,11269
MMG,600,450,0.0012520868113522537,0.02820519986562431,150,11269
SoA heuristic,1000,750,0.0007507507507507507,0.0006361000705510378,250,31381
MMG,1000,750,0.0007507507507507507,0.07486540009267628,250,31381
SoA heuristic,2000,1500,0.00037518759379689845,0.0011588998604565859,500,125208
MMG,2000,1500,0.00037518759379689845,0.29945260006934404,500,125208
SoA heuristic,4000,3000,0.00018754688672168043,0.0027364999987185,1000,500589
MMG,4000,3000,0.00018754688672168043,1.187938000075519,1000,500589
SoA heuristic,8000,6000,9.376172021502688e-05,0.005506400018930435,2000,1999648
MMG,8000,6000,9.376172021502688e-05,4.695185899967328,2000,1999648
SoA heuristic,20,15,0.039473684210526314,2.219993621110916e-05,5,12
MMG,20,15,0.039473684210526314,9.869993664324284e-05,5,12
SoA heuristic,40,30,0.019230769230769232,2.8799986466765404e-05,10,56
MMG,40,30,0.019230769230769232,0.000224800081923604,10,56
SoA heuristic,100,75,0.007575757575757576,5.9399986639618874e-05,25,326
MMG,100,75,0.007575757575757576,0.0009379000402987003,25,326
SoA heuristic,200,150,0.0037688442211055275,0.00010829977691173553,50,1244
MMG,200,150,0.0037688442211055275,0.003234699834138155,50,1244
SoA heuristic,400,300,0.0018796992481203006,0.00020910007879137993,100,4974
MMG,400,300,0.0018796992481203006,0.012675999896600842,100,4974
SoA heuristic,600,450,0.0012520868113522537,0.0003114000428467989,150,11321
MMG,600,450,0.0012520868113522537,0.0279061000328511,150,11321
SoA heuristic,1000,750,0.0007507507507507507,0.0005622999742627144,250,31280
MMG,1000,750,0.0007507507507507507,0.07544120005331933,250,31280
SoA heuristic,2000,1500,0.00037518759379689845,0.001137099927291274,500,125002
MMG,2000,1500,0.00037518759379689845,0.29498640005476773,500,125002
SoA heuristic,4000,3000,0.00018754688672168043,0.0023268000222742558,1000,500179
MMG,4000,3000,0.00018754688672168043,1.1917715000454336,1000,500179
SoA heuristic,8000,6000,9.376172021502688e-05,0.005389499943703413,2000,1999955
MMG,8000,6000,9.376172021502688e-05,4.544620499946177,2000,1999955
SoA heuristic,20,15,0.039473684210526314,2.159993164241314e-05,5,12
MMG,20,15,0.039473684210526314,0.00010120007209479809,5,12
SoA heuristic,40,30,0.019230769230769232,3.120000474154949e-05,10,64
MMG,40,30,0.019230769230769232,0.00023369980044662952,10,64
SoA heuristic,100,75,0.007575757575757576,6.04002270847559e-05,25,300
MMG,100,75,0.007575757575757576,0.0010239998809993267,25,300
SoA heuristic,200,150,0.0037688442211055275,0.00011110003106296062,50,1210
MMG,200,150,0.0037688442211055275,0.0034312999341636896,50,1210
SoA heuristic,400,300,0.0018796992481203006,0.00020979996770620346,100,4854
MMG,400,300,0.0018796992481203006,0.01241910015232861,100,4854
SoA heuristic,600,450,0.0012520868113522537,0.00030860002152621746,150,11204
MMG,600,450,0.0012520868113522537,0.027744300197809935,150,11204
SoA heuristic,1000,750,0.0007507507507507507,0.0007549000438302755,250,31064
MMG,1000,750,0.0007507507507507507,0.07486870000138879,250,31064
SoA heuristic,2000,1500,0.00037518759379689845,0.0011348999105393887,500,125089
MMG,2000,1500,0.00037518759379689845,0.2964190000202507,500,125089
SoA heuristic,4000,3000,0.00018754688672168043,0.0023769999388605356,1000,500380
MMG,4000,3000,0.00018754688672168043,1.2144442000426352,1000,500380
SoA heuristic,8000,6000,9.376172021502688e-05,0.0051413001492619514,2000,1999298
MMG,8000,6000,9.376172021502688e-05,4.619076399831101,2000,1999298
SoA heuristic,20,15,0.039473684210526314,2.459995448589325e-05,5,12
MMG,20,15,0.039473684210526314,0.0001409999094903469,5,12
SoA heuristic,40,30,0.019230769230769232,3.1299889087677e-05,10,45
MMG,40,30,0.019230769230769232,0.00024030008353292942,10,45
SoA heuristic,100,75,0.007575757575757576,6.370013579726219e-05,25,305
MMG,100,75,0.007575757575757576,0.0009792998898774385,25,305
SoA heuristic,200,150,0.0037688442211055275,0.00011350004933774471,50,1244
MMG,200,150,0.0037688442211055275,0.0034000000450760126,50,1244
SoA heuristic,400,300,0.0018796992481203006,0.0002397000789642334,100,4941
MMG,400,300,0.0018796992481203006,0.012739399913698435,100,4941
SoA heuristic,600,450,0.0012520868113522537,0.0003175002057105303,150,11398
MMG,600,450,0.0012520868113522537,0.028000100050121546,150,11398
SoA heuristic,1000,750,0.0007507507507507507,0.0006399999838322401,250,31243
MMG,1000,750,0.0007507507507507507,0.07792200008407235,250,31243
SoA heuristic,2000,1500,0.00037518759379689845,0.0011203999165445566,500,125207
MMG,2000,1500,0.00037518759379689845,0.2950674998573959,500,125207
SoA heuristic,4000,3000,0.00018754688672168043,0.002227099845185876,1000,499572
MMG,4000,3000,0.00018754688672168043,1.2258963999338448,1000,499572
SoA heuristic,8000,6000,9.376172021502688e-05,0.005540099926292896,2000,2000097
MMG,8000,6000,9.376172021502688e-05,4.88709169998765,2000,2000097
SoA heuristic,20,15,0.039473684210526314,2.5300076231360435e-05,5,10
MMG,20,15,0.039473684210526314,0.00010870001278817654,5,10
SoA heuristic,40,30,0.019230769230769232,3.8400059565901756e-05,10,47
MMG,40,30,0.019230769230769232,0.00026030000299215317,10,47
SoA heuristic,100,75,0.007575757575757576,5.889986641705036e-05,25,322
MMG,100,75,0.007575757575757576,0.0010110000148415565,25,322
SoA heuristic,200,150,0.0037688442211055275,0.00012039998546242714,50,1233
MMG,200,150,0.0037688442211055275,0.00352009991183877,50,1233
SoA heuristic,400,300,0.0018796992481203006,0.00023479992523789406,100,4916
MMG,400,300,0.0018796992481203006,0.015420700190588832,100,4916
SoA heuristic,600,450,0.0012520868113522537,0.0003690999001264572,150,11315
MMG,600,450,0.0012520868113522537,0.03115410008467734,150,11315
SoA heuristic,1000,750,0.0007507507507507507,0.0006312001496553421,250,31299
MMG,1000,750,0.0007507507507507507,0.07831230014562607,250,31299
SoA heuristic,2000,1500,0.00037518759379689845,0.0011614998802542686,500,125280
MMG,2000,1500,0.00037518759379689845,0.299661299912259,500,125280
SoA heuristic,4000,3000,0.00018754688672168043,0.0025291999336332083,1000,499545
MMG,4000,3000,0.00018754688672168043,1.2963280999101698,1000,499545
SoA heuristic,8000,6000,9.376172021502688e-05,0.005347199970856309,2000,1998784
MMG,8000,6000,9.376172021502688e-05,4.887779499869794,2000,1998784
SoA heuristic,20,15,0.039473684210526314,2.2300053387880325e-05,5,13
MMG,20,15,0.039473684210526314,0.0001042000949382782,5,13
SoA heuristic,40,30,0.019230769230769232,3.060000017285347e-05,10,56
MMG,40,30,0.019230769230769232,0.00023380015045404434,10,56
SoA heuristic,100,75,0.007575757575757576,6.220000796020031e-05,25,309
MMG,100,75,0.007575757575757576,0.0010041000787168741,25,309
SoA heuristic,200,150,0.0037688442211055275,0.00011150003410875797,50,1254
MMG,200,150,0.0037688442211055275,0.003398899920284748,50,1254
SoA heuristic,400,300,0.0018796992481203006,0.00021079997532069683,100,5053
MMG,400,300,0.0018796992481203006,0.012686800211668015,100,5053
SoA heuristic,600,450,0.0012520868113522537,0.0003263000398874283,150,11136
MMG,600,450,0.0012520868113522537,0.028381400043144822,150,11136
SoA heuristic,1000,750,0.0007507507507507507,0.000609799986705184,250,31184
MMG,1000,750,0.0007507507507507507,0.07594439992681146,250,31184
SoA heuristic,2000,1500,0.00037518759379689845,0.0014671001117676497,500,124759
MMG,2000,1500,0.00037518759379689845,0.2992499000392854,500,124759
SoA heuristic,4000,3000,0.00018754688672168043,0.002579099964350462,1000,499959
MMG,4000,3000,0.00018754688672168043,1.2005545999854803,1000,499959
SoA heuristic,8000,6000,9.376172021502688e-05,0.005275900010019541,2000,1999913
MMG,8000,6000,9.376172021502688e-05,4.877079600002617,2000,1999913
