name,nodes,edges,density,time,result_set,result_w
SoA heuristic,4000,3000,0.00018754688672168043,0.0051679001189768314,1000,1985
MMG,4000,3000,0.00018754688672168043,1.902526100166142,1000,1985
SoA heuristic,4020,3015,0.00018661358546902214,0.007159399800002575,1005,2040
MMG,4020,3015,0.00018661358546902214,1.7919411000330001,1005,2040
SoA heuristic,4040,3030,0.00018568952711067095,0.0026656000409275293,1010,1999
MMG,4040,3030,0.00018568952711067095,2.038051800103858,1010,1999
SoA heuristic,4080,3060,0.00018386859524393233,0.006634399993345141,1020,2022
MMG,4080,3060,0.00018386859524393233,1.840775600168854,1020,2022
SoA heuristic,4120,3090,0.0001820830298616169,0.005996400024741888,1030,2021
MMG,4120,3090,0.0001820830298616169,2.095576199935749,1030,2021
SoA heuristic,4200,3150,0.00017861395570373899,0.0026171000208705664,1050,2103
MMG,4200,3150,0.00017861395570373899,2.0839811000041664,1050,2103
SoA heuristic,4240,3180,0.00017692852087756547,0.0022141002118587494,1060,2099
MMG,4240,3180,0.00017692852087756547,2.2789602000266314,1060,2099
SoA heuristic,4400,3300,0.00017049329393043874,0.0027905998285859823,1100,2252
MMG,4400,3300,0.00017049329393043874,2.188392800046131,1100,2252
SoA heuristic,4600,3450,0.00016307893020221786,0.005199099890887737,1150,2276
MMG,4600,3450,0.00016307893020221786,2.2994723001029342,1150,2276
SoA heuristic,4000,3000,0.00018754688672168043,0.002311999909579754,1000,1991
MMG,4000,3000,0.00018754688672168043,1.1985160999465734,1000,1991
SoA heuristic,4020,3015,0.00018661358546902214,0.002303000073879957,1005,1991
MMG,4020,3015,0.00018661358546902214,1.2166875000111759,1005,1991
SoA heuristic,4040,3030,0.00018568952711067095,0.002448400016874075,1010,1924
MMG,4040,3030,0.00018568952711067095,1.2025103000923991,1010,1924
SoA heuristic,4080,3060,0.00018386859524393233,0.002714300062507391,1020,1922
MMG,4080,3060,0.00018386859524393233,1.3471566000953317,1020,1922
SoA heuristic,4120,3090,0.0001820830298616169,0.0021957000717520714,1030,2024
MMG,4120,3090,0.0001820830298616169,1.9076876998879015,1030,2024
SoA heuristic,4200,3150,0.00017861395570373899,0.00500490004196763,1050,2045
MMG,4200,3150,0.00017861395570373899,2.185491600073874,1050,2045
SoA heuristic,4240,3180,0.00017692852087756547,0.006833500228822231,1060,2087
MMG,4240,3180,0.00017692852087756547,2.061881799949333,1060,2087
SoA heuristic,4400,3300,0.00017049329393043874,0.0023113000206649303,1100,2162
MMG,4400,3300,0.00017049329393043874,2.225219300016761,1100,2162
SoA heuristic,4600,3450,0.00016307893020221786,0.007896200055256486,1150,2236
MMG,4600,3450,0.00016307893020221786,2.565312100108713,1150,2236
SoA heuristic,4000,3000,0.00018754688672168043,0.005264900159090757,1000,2065
MMG,4000,3000,0.00018754688672168043,1.6065454999916255,1000,2065
SoA heuristic,4020,3015,0.00018661358546902214,0.003644700162112713,1005,2037
MMG,4020,3015,0.00018661358546902214,1.6697380000259727,1005,2037
SoA heuristic,4040,3030,0.00018568952711067095,0.0024212999269366264,1010,1957
MMG,4040,3030,0.00018568952711067095,1.831716899992898,1010,1957
SoA heuristic,4080,3060,0.00018386859524393233,0.007509500021114945,1020,2017
MMG,4080,3060,0.00018386859524393233,2.100184899987653,1020,2017
SoA heuristic,4120,3090,0.0001820830298616169,0.0021297999192029238,1030,1982
MMG,4120,3090,0.0001820830298616169,1.895382900023833,1030,1982
SoA heuristic,4200,3150,0.00017861395570373899,0.0049056001007556915,1050,2169
MMG,4200,3150,0.00017861395570373899,2.046646799892187,1050,2169
SoA heuristic,4240,3180,0.00017692852087756547,0.002715999959036708,1060,2150
MMG,4240,3180,0.00017692852087756547,2.0626586999278516,1060,2150
SoA heuristic,4400,3300,0.00017049329393043874,0.006879799999296665,1100,2132
MMG,4400,3300,0.00017049329393043874,2.2469504999462515,1100,2132
SoA heuristic,4600,3450,0.00016307893020221786,0.004803200019523501,1150,2293
MMG,4600,3450,0.00016307893020221786,2.254537999862805,1150,2293
SoA heuristic,4000,3000,0.00018754688672168043,0.0023773000575602055,1000,1899
MMG,4000,3000,0.00018754688672168043,2.0755927998106927,1000,1899
SoA heuristic,4020,3015,0.00018661358546902214,0.003523200051859021,1005,1971
MMG,4020,3015,0.00018661358546902214,1.905601599952206,1005,1971
SoA heuristic,4040,3030,0.00018568952711067095,0.002201500115916133,1010,2132
MMG,4040,3030,0.00018568952711067095,1.9217234998941422,1010,2132
SoA heuristic,4080,3060,0.00018386859524393233,0.004563699942082167,1020,2051
MMG,4080,3060,0.00018386859524393233,1.8945710000116378,1020,2051
SoA heuristic,4120,3090,0.0001820830298616169,0.0041859999764710665,1030,2067
MMG,4120,3090,0.0001820830298616169,2.099078099941835,1030,2067
SoA heuristic,4200,3150,0.00017861395570373899,0.03766979998908937,1050,2081
MMG,4200,3150,0.00017861395570373899,2.237928600050509,1050,2081
SoA heuristic,4240,3180,0.00017692852087756547,0.00449520000256598,1060,2122
MMG,4240,3180,0.00017692852087756547,2.179438600083813,1060,2122
SoA heuristic,4400,3300,0.00017049329393043874,0.003943399991840124,1100,2237
MMG,4400,3300,0.00017049329393043874,2.2278103998396546,1100,2237
SoA heuristic,4600,3450,0.00016307893020221786,0.004786100005730987,1150,2183
MMG,4600,3450,0.00016307893020221786,2.4312967997975647,1150,2183
SoA heuristic,4000,3000,0.00018754688672168043,0.002772199921309948,1000,2002
MMG,4000,3000,0.00018754688672168043,1.4337412999011576,1000,2002
SoA heuristic,4020,3015,0.00018661358546902214,0.0035348001401871443,1005,1984
MMG,4020,3015,0.00018661358546902214,1.4463737001642585,1005,1984
SoA heuristic,4040,3030,0.00018568952711067095,0.0027443000581115484,1010,2011
MMG,4040,3030,0.00018568952711067095,1.4509603001642972,1010,2011
SoA heuristic,4080,3060,0.00018386859524393233,0.003096299944445491,1020,1999
MMG,4080,3060,0.00018386859524393233,1.5026267000939697,1020,1999
SoA heuristic,4120,3090,0.0001820830298616169,0.0026553000789135695,1030,2006
MMG,4120,3090,0.0001820830298616169,1.5073546001221985,1030,2006
SoA heuristic,4200,3150,0.00017861395570373899,0.035571200074627995,1050,2019
MMG,4200,3150,0.00017861395570373899,1.5677979001775384,1050,2019
SoA heuristic,4240,3180,0.00017692852087756547,0.003354799933731556,1060,2124
MMG,4240,3180,0.00017692852087756547,1.7289197000209242,1060,2124
SoA heuristic,4400,3300,0.00017049329393043874,0.0037588002160191536,1100,2137
MMG,4400,3300,0.00017049329393043874,1.7604532002005726,1100,2137
SoA heuristic,4600,3450,0.00016307893020221786,0.03423390001989901,1150,2308
MMG,4600,3450,0.00016307893020221786,1.9488378998357803,1150,2308
SoA heuristic,4000,3000,0.00018754688672168043,0.0028844999615103006,1000,1934
MMG,4000,3000,0.00018754688672168043,1.398176700109616,1000,1934
SoA heuristic,4020,3015,0.00018661358546902214,0.003710199845954776,1005,1979
MMG,4020,3015,0.00018661358546902214,1.4944112000521272,1005,1979
SoA heuristic,4040,3030,0.00018568952711067095,0.0029013999737799168,1010,2049
MMG,4040,3030,0.00018568952711067095,1.3957601999863982,1010,2049
SoA heuristic,4080,3060,0.00018386859524393233,0.0029229000210762024,1020,2105
MMG,4080,3060,0.00018386859524393233,1.48271180014126,1020,2105
SoA heuristic,4120,3090,0.0001820830298616169,0.0026507999282330275,1030,1983
MMG,4120,3090,0.0001820830298616169,1.5640298000071198,1030,1983
SoA heuristic,4200,3150,0.00017861395570373899,0.003688700031489134,1050,2181
MMG,4200,3150,0.00017861395570373899,2.1817308999598026,1050,2181
SoA heuristic,4240,3180,0.00017692852087756547,0.0028250000905245543,1060,2053
MMG,4240,3180,0.00017692852087756547,1.5412393000442535,1060,2053
SoA heuristic,4400,3300,0.00017049329393043874,0.0029357001185417175,1100,2198
MMG,4400,3300,0.00017049329393043874,2.1631505000405014,1100,2198
SoA heuristic,4600,3450,0.00016307893020221786,0.004981500096619129,1150,2327
MMG,4600,3450,0.00016307893020221786,2.205515000037849,1150,2327
SoA heuristic,4000,3000,0.00018754688672168043,0.0023366000968962908,1000,2025
MMG,4000,3000,0.00018754688672168043,1.1835227000992745,1000,2025
SoA heuristic,4020,3015,0.00018661358546902214,0.00280330004170537,1005,2002
MMG,4020,3015,0.00018661358546902214,1.185633399989456,1005,2002
SoA heuristic,4040,3030,0.00018568952711067095,0.0023256000131368637,1010,2046
MMG,4040,3030,0.00018568952711067095,1.1981261000037193,1010,2046
SoA heuristic,4080,3060,0.00018386859524393233,0.002798799891024828,1020,2034
MMG,4080,3060,0.00018386859524393233,1.2150129999499768,1020,2034
SoA heuristic,4120,3090,0.0001820830298616169,0.0023848998825997114,1030,2115
MMG,4120,3090,0.0001820830298616169,1.2482024000491947,1030,2115
SoA heuristic,4200,3150,0.00017861395570373899,0.002724100137129426,1050,2097
MMG,4200,3150,0.00017861395570373899,1.2940571000799537,1050,2097
SoA heuristic,4240,3180,0.00017692852087756547,0.0024470000062137842,1060,2048
MMG,4240,3180,0.00017692852087756547,1.3171693000476807,1060,2048
SoA heuristic,4400,3300,0.00017049329393043874,0.0025233998894691467,1100,2168
MMG,4400,3300,0.00017049329393043874,1.4228815999813378,1100,2168
SoA heuristic,4600,3450,0.00016307893020221786,0.002622599946334958,1150,2294
MMG,4600,3450,0.00016307893020221786,1.555962200043723,1150,2294
SoA heuristic,4000,3000,0.00018754688672168043,0.0026298000011593103,1000,1997
MMG,4000,3000,0.00018754688672168043,1.1898856998886913,1000,1997
SoA heuristic,4020,3015,0.00018661358546902214,0.0023990999907255173,1005,2022
MMG,4020,3015,0.00018661358546902214,1.206856100121513,1005,2022
SoA heuristic,4040,3030,0.00018568952711067095,0.002724599791690707,1010,2049
MMG,4040,3030,0.00018568952711067095,1.153954999987036,1010,2049
SoA heuristic,4080,3060,0.00018386859524393233,0.0021858999971300364,1020,1947
MMG,4080,3060,0.00018386859524393233,1.1558141000568867,1020,1947
SoA heuristic,4120,3090,0.0001820830298616169,0.002607200061902404,1030,2029
MMG,4120,3090,0.0001820830298616169,1.25611890014261,1030,2029
SoA heuristic,4200,3150,0.00017861395570373899,0.0024197001475840807,1050,2102
MMG,4200,3150,0.00017861395570373899,1.2136458000168204,1050,2102
SoA heuristic,4240,3180,0.00017692852087756547,0.027387599926441908,1060,2166
MMG,4240,3180,0.00017692852087756547,1.3243886998388916,1060,2166
SoA heuristic,4400,3300,0.00017049329393043874,0.0026312998961657286,1100,2259
MMG,4400,3300,0.00017049329393043874,1.3501322001684457,1100,2259
SoA heuristic,4600,3450,0.00016307893020221786,0.0024500000290572643,1150,2323
MMG,4600,3450,0.00016307893020221786,1.6093269002158195,1150,2323
SoA heuristic,4000,3000,0.00018754688672168043,0.0021377999801188707,1000,1916
MMG,4000,3000,0.00018754688672168043,1.5942260001320392,1000,1916
SoA heuristic,4020,3015,0.00018661358546902214,0.0023706001229584217,1005,2044
MMG,4020,3015,0.00018661358546902214,1.7089976000133902,1005,2044
SoA heuristic,4040,3030,0.00018568952711067095,0.0038429999258369207,1010,2003
MMG,4040,3030,0.00018568952711067095,1.7690002999734133,1010,2003
SoA heuristic,4080,3060,0.00018386859524393233,0.004528299905359745,1020,2045
MMG,4080,3060,0.00018386859524393233,1.7430865000933409,1020,2045
SoA heuristic,4120,3090,0.0001820830298616169,0.0025394000113010406,1030,2033
MMG,4120,3090,0.0001820830298616169,1.8243883999530226,1030,2033
SoA heuristic,4200,3150,0.00017861395570373899,0.006906300084665418,1050,2130
MMG,4200,3150,0.00017861395570373899,1.9867539999540895,1050,2130
SoA heuristic,4240,3180,0.00017692852087756547,0.004052399890497327,1060,2147
MMG,4240,3180,0.00017692852087756547,1.8155030000489205,1060,2147
SoA heuristic,4400,3300,0.00017049329393043874,0.0022885999642312527,1100,2166
MMG,4400,3300,0.00017049329393043874,1.857530599925667,1100,2166
SoA heuristic,4600,3450,0.00016307893020221786,0.008189799962565303,1150,2387
MMG,4600,3450,0.00016307893020221786,2.7806805002037436,1150,2387
SoA heuristic,4000,3000,0.00018754688672168043,0.0037867999635636806,1000,1902
MMG,4000,3000,0.00018754688672168043,1.771178999915719,1000,1902
SoA heuristic,4020,3015,0.00018661358546902214,0.0020616999827325344,1005,1934
MMG,4020,3015,0.00018661358546902214,1.6576981998514384,1005,1934
SoA heuristic,4040,3030,0.00018568952711067095,0.00292569980956614,1010,1952
MMG,4040,3030,0.00018568952711067095,1.873876699944958,1010,1952
SoA heuristic,4080,3060,0.00018386859524393233,0.002037100028246641,1020,2080
MMG,4080,3060,0.00018386859524393233,1.889093300094828,1020,2080
SoA heuristic,4120,3090,0.0001820830298616169,0.007638499839231372,1030,2059
MMG,4120,3090,0.0001820830298616169,1.9458637998905033,1030,2059
SoA heuristic,4200,3150,0.00017861395570373899,0.0022458999883383512,1050,2146
MMG,4200,3150,0.00017861395570373899,1.9313741000369191,1050,2146
SoA heuristic,4240,3180,0.00017692852087756547,0.0023016000632196665,1060,2033
MMG,4240,3180,0.00017692852087756547,1.7515866998583078,1060,2033
SoA heuristic,4400,3300,0.00017049329393043874,0.0055044000037014484,1100,2229
MMG,4400,3300,0.00017049329393043874,2.1118993998970836,1100,2229
SoA heuristic,4600,3450,0.00016307893020221786,0.0023773000575602055,1150,2337
MMG,4600,3450,0.00016307893020221786,1.949478599941358,1150,2337
SoA heuristic,4000,3000,0.00018754688672168043,0.002692500129342079,1000,2039
MMG,4000,3000,0.00018754688672168043,1.5705051999539137,1000,2039
SoA heuristic,4020,3015,0.00018661358546902214,0.0050357000436633825,1005,1964
MMG,4020,3015,0.00018661358546902214,1.8473748001269996,1005,1964
SoA heuristic,4040,3030,0.00018568952711067095,0.009778199950233102,1010,2075
MMG,4040,3030,0.00018568952711067095,2.0665595000609756,1010,2075
SoA heuristic,4080,3060,0.00018386859524393233,0.006435499992221594,1020,2060
MMG,4080,3060,0.00018386859524393233,1.7678400001022965,1020,2060
SoA heuristic,4120,3090,0.0001820830298616169,0.0026319001335650682,1030,2081
MMG,4120,3090,0.0001820830298616169,1.7043542999308556,1030,2081
SoA heuristic,4200,3150,0.00017861395570373899,0.002578000072389841,1050,2082
MMG,4200,3150,0.00017861395570373899,1.5465383999980986,1050,2082
SoA heuristic,4240,3180,0.00017692852087756547,0.002816700143739581,1060,2117
MMG,4240,3180,0.00017692852087756547,1.840818699914962,1060,2117
SoA heuristic,4400,3300,0.00017049329393043874,0.005678800167515874,1100,2193
MMG,4400,3300,0.00017049329393043874,1.9990522000007331,1100,2193
SoA heuristic,4600,3450,0.00016307893020221786,0.003175900084897876,1150,2282
MMG,4600,3450,0.00016307893020221786,2.2641308999154717,1150,2282
SoA heuristic,4000,3000,0.00018754688672168043,0.007653400069102645,1000,2019
MMG,4000,3000,0.00018754688672168043,1.6911150999367237,1000,2019
SoA heuristic,4020,3015,0.00018661358546902214,0.00476779998280108,1005,2010
MMG,4020,3015,0.00018661358546902214,1.8476340998895466,1005,2010
SoA heuristic,4040,3030,0.00018568952711067095,0.0039530000649392605,1010,1993
MMG,4040,3030,0.00018568952711067095,1.8174085000064224,1010,1993
SoA heuristic,4080,3060,0.00018386859524393233,0.03368219989351928,1020,1987
MMG,4080,3060,0.00018386859524393233,1.8299418999813497,1020,1987
SoA heuristic,4120,3090,0.0001820830298616169,0.002585599897429347,1030,2030
MMG,4120,3090,0.0001820830298616169,1.7044408000074327,1030,2030
SoA heuristic,4200,3150,0.00017861395570373899,0.006934399949386716,1050,2115
MMG,4200,3150,0.00017861395570373899,2.0256185000762343,1050,2115
SoA heuristic,4240,3180,0.00017692852087756547,0.008341799955815077,1060,2068
MMG,4240,3180,0.00017692852087756547,2.2985321001615375,1060,2068
SoA heuristic,4400,3300,0.00017049329393043874,0.0027804002165794373,1100,2248
MMG,4400,3300,0.00017049329393043874,2.010123400017619,1100,2248
SoA heuristic,4600,3450,0.00016307893020221786,0.003495899960398674,1150,2375
MMG,4600,3450,0.00016307893020221786,2.640283699845895,1150,2375
SoA heuristic,4000,3000,0.00018754688672168043,0.00484960014000535,1000,1952
MMG,4000,3000,0.00018754688672168043,1.5744487999472767,1000,1952
SoA heuristic,4020,3015,0.00018661358546902214,0.0021087999921292067,1005,2056
MMG,4020,3015,0.00018661358546902214,1.6725743999704719,1005,2056
SoA heuristic,4040,3030,0.00018568952711067095,0.002206699922680855,1010,1953
MMG,4040,3030,0.00018568952711067095,1.7025637000333518,1010,1953
SoA heuristic,4080,3060,0.00018386859524393233,0.0029253000393509865,1020,2017
MMG,4080,3060,0.00018386859524393233,1.820648399880156,1020,2017
SoA heuristic,4120,3090,0.0001820830298616169,0.0021967999637126923,1030,2128
MMG,4120,3090,0.0001820830298616169,1.8990871000569314,1030,2128
SoA heuristic,4200,3150,0.00017861395570373899,0.003247200045734644,1050,2040
MMG,4200,3150,0.00017861395570373899,1.9294761999044567,1050,2040
SoA heuristic,4240,3180,0.00017692852087756547,0.035091300029307604,1060,2127
MMG,4240,3180,0.00017692852087756547,2.233951599802822,1060,2127
SoA heuristic,4400,3300,0.00017049329393043874,0.0029946998693048954,1100,2204
MMG,4400,3300,0.00017049329393043874,2.0481927001383156,1100,2204
SoA heuristic,4600,3450,0.00016307893020221786,0.0063680000603199005,1150,2235
MMG,4600,3450,0.00016307893020221786,2.2103844999801368,1150,2235
SoA heuristic,4000,3000,0.00018754688672168043,0.0033935001119971275,1000,1939
MMG,4000,3000,0.00018754688672168043,1.9130673001054674,1000,1939
SoA heuristic,4020,3015,0.00018661358546902214,0.0032355000730603933,1005,2060
MMG,4020,3015,0.00018661358546902214,2.0108276000246406,1005,2060
SoA heuristic,4040,3030,0.00018568952711067095,0.002350699855014682,1010,1943
MMG,4040,3030,0.00018568952711067095,2.04653609986417,1010,1943
SoA heuristic,4080,3060,0.00018386859524393233,0.002051499905064702,1020,2054
MMG,4080,3060,0.00018386859524393233,2.1492953000124544,1020,2054
SoA heuristic,4120,3090,0.0001820830298616169,0.04994020005688071,1030,2045
MMG,4120,3090,0.0001820830298616169,1.9064052999019623,1030,2045
SoA heuristic,4200,3150,0.00017861395570373899,0.007752400124445558,1050,2050
MMG,4200,3150,0.00017861395570373899,2.0276550000999123,1050,2050
SoA heuristic,4240,3180,0.00017692852087756547,0.006658099824562669,1060,2123
MMG,4240,3180,0.00017692852087756547,2.179941799957305,1060,2123
SoA heuristic,4400,3300,0.00017049329393043874,0.0023211000952869654,1100,2127
MMG,4400,3300,0.00017049329393043874,2.216156599810347,1100,2127
SoA heuristic,4600,3450,0.00016307893020221786,0.0023990999907255173,1150,2219
MMG,4600,3450,0.00016307893020221786,2.273475700058043,1150,2219
SoA heuristic,4000,3000,0.00018754688672168043,0.002441700082272291,1000,2066
MMG,4000,3000,0.00018754688672168043,1.9150334000587463,1000,2066
SoA heuristic,4020,3015,0.00018661358546902214,0.0027250999119132757,1005,2004
MMG,4020,3015,0.00018661358546902214,1.852406700141728,1005,2004
SoA heuristic,4040,3030,0.00018568952711067095,0.0032040998339653015,1010,2020
MMG,4040,3030,0.00018568952711067095,1.9585522001143545,1010,2020
SoA heuristic,4080,3060,0.00018386859524393233,0.0021008001640439034,1020,2085
MMG,4080,3060,0.00018386859524393233,1.9750085999257863,1020,2085
SoA heuristic,4120,3090,0.0001820830298616169,0.0041155999060720205,1030,2083
MMG,4120,3090,0.0001820830298616169,1.92890359996818,1030,2083
SoA heuristic,4200,3150,0.00017861395570373899,0.002512499922886491,1050,2139
MMG,4200,3150,0.00017861395570373899,2.105476099997759,1050,2139
SoA heuristic,4240,3180,0.00017692852087756547,0.005430599907413125,1060,2117
MMG,4240,3180,0.00017692852087756547,2.0556461999658495,1060,2117
SoA heuristic,4400,3300,0.00017049329393043874,0.002786400029435754,1100,2167
MMG,4400,3300,0.00017049329393043874,2.234184700064361,1100,2167
SoA heuristic,4600,3450,0.00016307893020221786,0.002401200123131275,1150,2382
MMG,4600,3450,0.00016307893020221786,2.64943730016239,1150,2382
SoA heuristic,4000,3000,0.00018754688672168043,0.007264899788424373,1000,1977
MMG,4000,3000,0.00018754688672168043,1.7196983001194894,1000,1977
SoA heuristic,4020,3015,0.00018661358546902214,0.0020839001517742872,1005,1991
MMG,4020,3015,0.00018661358546902214,1.853403199929744,1005,1991
SoA heuristic,4040,3030,0.00018568952711067095,0.005219300044700503,1010,1994
MMG,4040,3030,0.00018568952711067095,1.750012599863112,1010,1994
SoA heuristic,4080,3060,0.00018386859524393233,0.0021905999165028334,1020,2055
MMG,4080,3060,0.00018386859524393233,1.7662865000311285,1020,2055
SoA heuristic,4120,3090,0.0001820830298616169,0.0029047999996691942,1030,2099
MMG,4120,3090,0.0001820830298616169,2.073532599955797,1030,2099
SoA heuristic,4200,3150,0.00017861395570373899,0.0021510999649763107,1050,2136
MMG,4200,3150,0.00017861395570373899,1.8272507002111524,1050,2136
SoA heuristic,4240,3180,0.00017692852087756547,0.0025051000993698835,1060,2072
MMG,4240,3180,0.00017692852087756547,1.80062250001356,1060,2072
SoA heuristic,4400,3300,0.00017049329393043874,0.008010500110685825,1100,2242
MMG,4400,3300,0.00017049329393043874,2.126969699980691,1100,2242
SoA heuristic,4600,3450,0.00016307893020221786,0.0024975999258458614,1150,2272
MMG,4600,3450,0.00016307893020221786,2.5094251001719385,1150,2272
SoA heuristic,4000,3000,0.00018754688672168043,0.0067813999485224485,1000,2064
MMG,4000,3000,0.00018754688672168043,1.8735201999079436,1000,2064
SoA heuristic,4020,3015,0.00018661358546902214,0.003181900130584836,1005,1969
MMG,4020,3015,0.00018661358546902214,1.946735099889338,1005,1969
SoA heuristic,4040,3030,0.00018568952711067095,0.0031405999325215816,1010,2129
MMG,4040,3030,0.00018568952711067095,2.0012036999687552,1010,2129
SoA heuristic,4080,3060,0.00018386859524393233,0.00255730003118515,1020,1977
MMG,4080,3060,0.00018386859524393233,1.9287390999961644,1020,1977
SoA heuristic,4120,3090,0.0001820830298616169,0.00205060001462698,1030,2112
MMG,4120,3090,0.0001820830298616169,1.7899968998972327,1030,2112
SoA heuristic,4200,3150,0.00017861395570373899,0.0034052999690175056,1050,2119
MMG,4200,3150,0.00017861395570373899,1.9326368998736143,1050,2119
SoA heuristic,4240,3180,0.00017692852087756547,0.0021818000823259354,1060,2153
MMG,4240,3180,0.00017692852087756547,2.077781799947843,1060,2153
SoA heuristic,4400,3300,0.00017049329393043874,0.005200299900025129,1100,2239
MMG,4400,3300,0.00017049329393043874,2.008990899892524,1100,2239
SoA heuristic,4600,3450,0.00016307893020221786,0.0023817000910639763,1150,2265
MMG,4600,3450,0.00016307893020221786,2.0950538001488894,1150,2265
SoA heuristic,4000,3000,0.00018754688672168043,0.0068286999594420195,1000,2043
MMG,4000,3000,0.00018754688672168043,1.5296249999664724,1000,2043
SoA heuristic,4020,3015,0.00018661358546902214,0.0023904000408947468,1005,2010
MMG,4020,3015,0.00018661358546902214,1.8736531001050025,1005,2010
SoA heuristic,4040,3030,0.00018568952711067095,0.0022582001984119415,1010,1993
MMG,4040,3030,0.00018568952711067095,1.7440651000943035,1010,1993
SoA heuristic,4080,3060,0.00018386859524393233,0.007410399848595262,1020,2069
MMG,4080,3060,0.00018386859524393233,1.5444718000944704,1020,2069
SoA heuristic,4120,3090,0.0001820830298616169,0.0026157000102102757,1030,1997
MMG,4120,3090,0.0001820830298616169,1.7991944001987576,1030,1997
SoA heuristic,4200,3150,0.00017861395570373899,0.02936700009740889,1050,2091
MMG,4200,3150,0.00017861395570373899,2.0175831001251936,1050,2091
SoA heuristic,4240,3180,0.00017692852087756547,0.007045400096103549,1060,2150
MMG,4240,3180,0.00017692852087756547,1.949209300102666,1060,2150
SoA heuristic,4400,3300,0.00017049329393043874,0.002571699908003211,1100,2189
MMG,4400,3300,0.00017049329393043874,2.1978102999273688,1100,2189
SoA heuristic,4600,3450,0.00016307893020221786,0.0036259000189602375,1150,2367
MMG,4600,3450,0.00016307893020221786,2.1139054000377655,1150,2367
SoA heuristic,4000,3000,0.00018754688672168043,0.008228500140830874,1000,2013
MMG,4000,3000,0.00018754688672168043,1.6739395000040531,1000,2013
SoA heuristic,4020,3015,0.00018661358546902214,0.002127500018104911,1005,2090
MMG,4020,3015,0.00018661358546902214,1.92764290003106,1005,2090
SoA heuristic,4040,3030,0.00018568952711067095,0.002616200130432844,1010,1968
MMG,4040,3030,0.00018568952711067095,2.058230500202626,1010,1968
SoA heuristic,4080,3060,0.00018386859524393233,0.007506099995225668,1020,1994
MMG,4080,3060,0.00018386859524393233,1.9333935999311507,1020,1994
SoA heuristic,4120,3090,0.0001820830298616169,0.007220899919047952,1030,2024
MMG,4120,3090,0.0001820830298616169,1.809508000034839,1030,2024
SoA heuristic,4200,3150,0.00017861395570373899,0.0021571998950093985,1050,2131
MMG,4200,3150,0.00017861395570373899,1.9454061998985708,1050,2131
SoA heuristic,4240,3180,0.00017692852087756547,0.008153599919751287,1060,2200
MMG,4240,3180,0.00017692852087756547,2.0695879999548197,1060,2200
SoA heuristic,4400,3300,0.00017049329393043874,0.002818500157445669,1100,2225
MMG,4400,3300,0.00017049329393043874,2.2981972999405116,1100,2225
SoA heuristic,4600,3450,0.00016307893020221786,0.0065790999215096235,1150,2268
MMG,4600,3450,0.00016307893020221786,2.581318899989128,1150,2268
SoA heuristic,4000,3000,0.00018754688672168043,0.007038800045847893,1000,1966
MMG,4000,3000,0.00018754688672168043,1.8641258999705315,1000,1966
SoA heuristic,4020,3015,0.00018661358546902214,0.0020876999478787184,1005,2018
MMG,4020,3015,0.00018661358546902214,1.8365277999546379,1005,2018
SoA heuristic,4040,3030,0.00018568952711067095,0.0026287001091986895,1010,1970
MMG,4040,3030,0.00018568952711067095,1.8514727000147104,1010,1970
SoA heuristic,4080,3060,0.00018386859524393233,0.0023737000301480293,1020,1998
MMG,4080,3060,0.00018386859524393233,1.5503136001061648,1020,1998
SoA heuristic,4120,3090,0.0001820830298616169,0.002798199886456132,1030,2064
MMG,4120,3090,0.0001820830298616169,1.8185826998669654,1030,2064
SoA heuristic,4200,3150,0.00017861395570373899,0.0028421999886631966,1050,2049
MMG,4200,3150,0.00017861395570373899,2.0539551998954266,1050,2049
SoA heuristic,4240,3180,0.00017692852087756547,0.00810600002296269,1060,2037
MMG,4240,3180,0.00017692852087756547,2.0519771999679506,1060,2037
SoA heuristic,4400,3300,0.00017049329393043874,0.004825999960303307,1100,2260
MMG,4400,3300,0.00017049329393043874,2.1445154000539333,1100,2260
SoA heuristic,4600,3450,0.00016307893020221786,0.004337500082328916,1150,2331
MMG,4600,3450,0.00016307893020221786,2.5259865000844,1150,2331
SoA heuristic,4000,3000,0.00018754688672168043,0.006647000089287758,1000,2016
MMG,4000,3000,0.00018754688672168043,2.0270840998273343,1000,2016
SoA heuristic,4020,3015,0.00018661358546902214,0.0028725999873131514,1005,1996
MMG,4020,3015,0.00018661358546902214,1.9083970999345183,1005,1996
SoA heuristic,4040,3030,0.00018568952711067095,0.0020881001837551594,1010,2062
MMG,4040,3030,0.00018568952711067095,1.9508632998913527,1010,2062
SoA heuristic,4080,3060,0.00018386859524393233,0.041379999835044146,1020,1985
MMG,4080,3060,0.00018386859524393233,1.9683025998529047,1020,1985
SoA heuristic,4120,3090,0.0001820830298616169,0.0034686001017689705,1030,2016
MMG,4120,3090,0.0001820830298616169,1.89039870002307,1030,2016
SoA heuristic,4200,3150,0.00017861395570373899,0.0026250998489558697,1050,2103
MMG,4200,3150,0.00017861395570373899,1.9718634001910686,1050,2103
SoA heuristic,4240,3180,0.00017692852087756547,0.007012999849393964,1060,2095
MMG,4240,3180,0.00017692852087756547,1.9850991000421345,1060,2095
SoA heuristic,4400,3300,0.00017049329393043874,0.005064600147306919,1100,2213
MMG,4400,3300,0.00017049329393043874,1.8263862999156117,1100,2213
SoA heuristic,4600,3450,0.00016307893020221786,0.002903599990531802,1150,2291
MMG,4600,3450,0.00016307893020221786,2.194950999924913,1150,2291
SoA heuristic,4000,3000,0.00018754688672168043,0.009324099868535995,1000,1971
MMG,4000,3000,0.00018754688672168043,1.74729899992235,1000,1971
SoA heuristic,4020,3015,0.00018661358546902214,0.0039676998276263475,1005,1992
MMG,4020,3015,0.00018661358546902214,1.8311421000398695,1005,1992
SoA heuristic,4040,3030,0.00018568952711067095,0.006762600038200617,1010,2056
MMG,4040,3030,0.00018568952711067095,1.8283563998993486,1010,2056
SoA heuristic,4080,3060,0.00018386859524393233,0.006100500002503395,1020,2030
MMG,4080,3060,0.00018386859524393233,1.5948113000486046,1020,2030
SoA heuristic,4120,3090,0.0001820830298616169,0.0026990000624209642,1030,2093
MMG,4120,3090,0.0001820830298616169,1.7887591000180691,1030,2093
SoA heuristic,4200,3150,0.00017861395570373899,0.005397600121796131,1050,2170
MMG,4200,3150,0.00017861395570373899,1.8495658000465482,1050,2170
SoA heuristic,4240,3180,0.00017692852087756547,0.007092599989846349,1060,2222
MMG,4240,3180,0.00017692852087756547,1.9845066999550909,1060,2222
SoA heuristic,4400,3300,0.00017049329393043874,0.002672899980098009,1100,2194
MMG,4400,3300,0.00017049329393043874,2.361414800165221,1100,2194
SoA heuristic,4600,3450,0.00016307893020221786,0.00246850005351007,1150,2251
MMG,4600,3450,0.00016307893020221786,2.2655877000652254,1150,2251
SoA heuristic,4000,3000,0.00018754688672168043,0.005412499886006117,1000,1955
MMG,4000,3000,0.00018754688672168043,1.7483882000669837,1000,1955
SoA heuristic,4020,3015,0.00018661358546902214,0.005121099995449185,1005,2061
MMG,4020,3015,0.00018661358546902214,1.9717935000080615,1005,2061
SoA heuristic,4040,3030,0.00018568952711067095,0.004625899950042367,1010,2063
MMG,4040,3030,0.00018568952711067095,1.9596468000672758,1010,2063
SoA heuristic,4080,3060,0.00018386859524393233,0.005140000022947788,1020,2016
MMG,4080,3060,0.00018386859524393233,1.899536999873817,1020,2016
SoA heuristic,4120,3090,0.0001820830298616169,0.0022230998147279024,1030,2060
MMG,4120,3090,0.0001820830298616169,1.7722370999399573,1030,2060
SoA heuristic,4200,3150,0.00017861395570373899,0.0027203999925404787,1050,2182
MMG,4200,3150,0.00017861395570373899,2.258906199829653,1050,2182
SoA heuristic,4240,3180,0.00017692852087756547,0.006567999953404069,1060,2045
MMG,4240,3180,0.00017692852087756547,2.079387800069526,1060,2045
SoA heuristic,4400,3300,0.00017049329393043874,0.0021927000489085913,1100,2205
MMG,4400,3300,0.00017049329393043874,2.281228099949658,1100,2205
SoA heuristic,4600,3450,0.00016307893020221786,0.008279399946331978,1150,2261
MMG,4600,3450,0.00016307893020221786,2.587644000072032,1150,2261
SoA heuristic,4000,3000,0.00018754688672168043,0.002459599869325757,1000,2014
MMG,4000,3000,0.00018754688672168043,1.982207699911669,1000,2014
SoA heuristic,4020,3015,0.00018661358546902214,0.0024163001216948032,1005,2000
MMG,4020,3015,0.00018661358546902214,1.8606685001868755,1005,2000
SoA heuristic,4040,3030,0.00018568952711067095,0.005588499829173088,1010,2046
MMG,4040,3030,0.00018568952711067095,1.8689956001471728,1010,2046
SoA heuristic,4080,3060,0.00018386859524393233,0.0021390998736023903,1020,2062
MMG,4080,3060,0.00018386859524393233,1.8870767999906093,1020,2062
SoA heuristic,4120,3090,0.0001820830298616169,0.003865000093355775,1030,2060
MMG,4120,3090,0.0001820830298616169,2.219247099943459,1030,2060
SoA heuristic,4200,3150,0.00017861395570373899,0.002643299987539649,1050,2117
MMG,4200,3150,0.00017861395570373899,2.3764649000950158,1050,2117
SoA heuristic,4240,3180,0.00017692852087756547,0.00217660004273057,1060,2115
MMG,4240,3180,0.00017692852087756547,2.04067420004867,1060,2115
SoA heuristic,4400,3300,0.00017049329393043874,0.007263900013640523,1100,2205
MMG,4400,3300,0.00017049329393043874,2.2842637998983264,1100,2205
SoA heuristic,4600,3450,0.00016307893020221786,0.010329700075089931,1150,2314
MMG,4600,3450,0.00016307893020221786,2.2243842999450862,1150,2314
SoA heuristic,4000,3000,0.00018754688672168043,0.0074275999795645475,1000,1951
MMG,4000,3000,0.00018754688672168043,1.8458646999206394,1000,1951
SoA heuristic,4020,3015,0.00018661358546902214,0.002105299849063158,1005,2017
MMG,4020,3015,0.00018661358546902214,1.6706363998819143,1005,2017
SoA heuristic,4040,3030,0.00018568952711067095,0.003843100043013692,1010,2068
MMG,4040,3030,0.00018568952711067095,1.9351278999820352,1010,2068
SoA heuristic,4080,3060,0.00018386859524393233,0.0051766999531537294,1020,2020
MMG,4080,3060,0.00018386859524393233,1.767782400129363,1020,2020
SoA heuristic,4120,3090,0.0001820830298616169,0.00353670003823936,1030,2067
MMG,4120,3090,0.0001820830298616169,1.5815054001286626,1030,2067
SoA heuristic,4200,3150,0.00017861395570373899,0.002152099972590804,1050,2185
MMG,4200,3150,0.00017861395570373899,2.204692899947986,1050,2185
SoA heuristic,4240,3180,0.00017692852087756547,0.002113400027155876,1060,2154
MMG,4240,3180,0.00017692852087756547,1.9835607002023607,1060,2154
SoA heuristic,4400,3300,0.00017049329393043874,0.002636200049892068,1100,2206
MMG,4400,3300,0.00017049329393043874,2.28349669999443,1100,2206
SoA heuristic,4600,3450,0.00016307893020221786,0.007669499842450023,1150,2289
MMG,4600,3450,0.00016307893020221786,2.4200017999392003,1150,2289
SoA heuristic,4000,3000,0.00018754688672168043,0.0033142000902444124,1000,2014
MMG,4000,3000,0.00018754688672168043,1.875541799934581,1000,2014
SoA heuristic,4020,3015,0.00018661358546902214,0.005781000014394522,1005,2084
MMG,4020,3015,0.00018661358546902214,1.881559900008142,1005,2084
SoA heuristic,4040,3030,0.00018568952711067095,0.0066500999964773655,1010,1948
MMG,4040,3030,0.00018568952711067095,1.881028400035575,1010,1948
SoA heuristic,4080,3060,0.00018386859524393233,0.004393299808725715,1020,1975
MMG,4080,3060,0.00018386859524393233,2.127137799980119,1020,1975
SoA heuristic,4120,3090,0.0001820830298616169,0.006529700011014938,1030,1982
MMG,4120,3090,0.0001820830298616169,1.992331099929288,1030,1982
SoA heuristic,4200,3150,0.00017861395570373899,0.004903000080958009,1050,2144
MMG,4200,3150,0.00017861395570373899,2.2672643000259995,1050,2144
SoA heuristic,4240,3180,0.00017692852087756547,0.0066443998366594315,1060,2119
MMG,4240,3180,0.00017692852087756547,2.028597099939361,1060,2119
SoA heuristic,4400,3300,0.00017049329393043874,0.002263000002130866,1100,2184
MMG,4400,3300,0.00017049329393043874,2.3024402998853475,1100,2184
SoA heuristic,4600,3450,0.00016307893020221786,0.0023442001547664404,1150,2251
MMG,4600,3450,0.00016307893020221786,2.750876600155607,1150,2251
SoA heuristic,4000,3000,0.00018754688672168043,0.005210899980738759,1000,2030
MMG,4000,3000,0.00018754688672168043,1.9953989000059664,1000,2030
SoA heuristic,4020,3015,0.00018661358546902214,0.007265700027346611,1005,2024
MMG,4020,3015,0.00018661358546902214,2.037939100060612,1005,2024
SoA heuristic,4040,3030,0.00018568952711067095,0.008851899998262525,1010,2015
MMG,4040,3030,0.00018568952711067095,1.8778062001802027,1010,2015
SoA heuristic,4080,3060,0.00018386859524393233,0.005293600028380752,1020,2000
MMG,4080,3060,0.00018386859524393233,1.9887481001205742,1020,2000
SoA heuristic,4120,3090,0.0001820830298616169,0.002129300031810999,1030,1973
MMG,4120,3090,0.0001820830298616169,1.663010299904272,1030,1973
SoA heuristic,4200,3150,0.00017861395570373899,0.044743800070136786,1050,2132
MMG,4200,3150,0.00017861395570373899,2.1345488999504596,1050,2132
SoA heuristic,4240,3180,0.00017692852087756547,0.007725900039076805,1060,2179
MMG,4240,3180,0.00017692852087756547,2.2070358998607844,1060,2179
SoA heuristic,4400,3300,0.00017049329393043874,0.002237999811768532,1100,2140
MMG,4400,3300,0.00017049329393043874,2.1844136000145227,1100,2140
SoA heuristic,4600,3450,0.00016307893020221786,0.007450099801644683,1150,2255
MMG,4600,3450,0.00016307893020221786,2.4632028001360595,1150,2255
SoA heuristic,4000,3000,0.00018754688672168043,0.002638299949467182,1000,1970
MMG,4000,3000,0.00018754688672168043,2.039902900112793,1000,1970
SoA heuristic,4020,3015,0.00018661358546902214,0.002166900085285306,1005,1945
MMG,4020,3015,0.00018661358546902214,1.7037637999746948,1005,1945
SoA heuristic,4040,3030,0.00018568952711067095,0.00553079997189343,1010,1990
MMG,4040,3030,0.00018568952711067095,1.9280638999771327,1010,1990
SoA heuristic,4080,3060,0.00018386859524393233,0.003828400047495961,1020,2021
MMG,4080,3060,0.00018386859524393233,2.150395000120625,1020,2021
SoA heuristic,4120,3090,0.0001820830298616169,0.002624700078740716,1030,2073
MMG,4120,3090,0.0001820830298616169,1.80598479998298,1030,2073
SoA heuristic,4200,3150,0.00017861395570373899,0.004530300153419375,1050,2077
MMG,4200,3150,0.00017861395570373899,2.018894699867815,1050,2077
SoA heuristic,4240,3180,0.00017692852087756547,0.00744209997355938,1060,2166
MMG,4240,3180,0.00017692852087756547,2.1721524000167847,1060,2166
SoA heuristic,4400,3300,0.00017049329393043874,0.006254900014027953,1100,2242
MMG,4400,3300,0.00017049329393043874,2.237809899961576,1100,2242
SoA heuristic,4600,3450,0.00016307893020221786,0.0024227998219430447,1150,2275
MMG,4600,3450,0.00016307893020221786,2.543329200008884,1150,2275
SoA heuristic,4000,3000,0.00018754688672168043,0.0025587999261915684,1000,1997
MMG,4000,3000,0.00018754688672168043,1.8070115000009537,1000,1997
SoA heuristic,4020,3015,0.00018661358546902214,0.003758199978619814,1005,1990
MMG,4020,3015,0.00018661358546902214,1.9282775002066046,1005,1990
SoA heuristic,4040,3030,0.00018568952711067095,0.005170100135728717,1010,2082
MMG,4040,3030,0.00018568952711067095,1.806709400145337,1010,2082
SoA heuristic,4080,3060,0.00018386859524393233,0.006608499912545085,1020,2007
MMG,4080,3060,0.00018386859524393233,1.8840946001000702,1020,2007
SoA heuristic,4120,3090,0.0001820830298616169,0.007215999998152256,1030,2080
MMG,4120,3090,0.0001820830298616169,2.1032664999365807,1030,2080
SoA heuristic,4200,3150,0.00017861395570373899,0.0020975000225007534,1050,2066
MMG,4200,3150,0.00017861395570373899,1.7786582000553608,1050,2066
SoA heuristic,4240,3180,0.00017692852087756547,0.0023548000026494265,1060,2152
MMG,4240,3180,0.00017692852087756547,2.0902333001140505,1060,2152
SoA heuristic,4400,3300,0.00017049329393043874,0.0022114000748842955,1100,2181
MMG,4400,3300,0.00017049329393043874,2.412214200012386,1100,2181
SoA heuristic,4600,3450,0.00016307893020221786,0.00726430001668632,1150,2202
MMG,4600,3450,0.00016307893020221786,2.768988600000739,1150,2202
SoA heuristic,4000,3000,0.00018754688672168043,0.004129699897021055,1000,2054
MMG,4000,3000,0.00018754688672168043,1.8329398001078516,1000,2054
SoA heuristic,4020,3015,0.00018661358546902214,0.00547760003246367,1005,2069
MMG,4020,3015,0.00018661358546902214,1.932255099993199,1005,2069
SoA heuristic,4040,3030,0.00018568952711067095,0.005297899944707751,1010,1962
MMG,4040,3030,0.00018568952711067095,2.038175699999556,1010,1962
SoA heuristic,4080,3060,0.00018386859524393233,0.002130799926817417,1020,2041
MMG,4080,3060,0.00018386859524393233,2.0413627999369055,1020,2041
SoA heuristic,4120,3090,0.0001820830298616169,0.007415599888190627,1030,2053
MMG,4120,3090,0.0001820830298616169,1.8643118001054972,1030,2053
SoA heuristic,4200,3150,0.00017861395570373899,0.005978900007903576,1050,2111
MMG,4200,3150,0.00017861395570373899,1.9611920001916587,1050,2111
SoA heuristic,4240,3180,0.00017692852087756547,0.002332499949261546,1060,2080
MMG,4240,3180,0.00017692852087756547,1.9304810999892652,1060,2080
SoA heuristic,4400,3300,0.00017049329393043874,0.002332900185137987,1100,2240
MMG,4400,3300,0.00017049329393043874,2.1637522999662906,1100,2240
SoA heuristic,4600,3450,0.00016307893020221786,0.007339800009503961,1150,2347
MMG,4600,3450,0.00016307893020221786,2.5828658000100404,1150,2347
SoA heuristic,4000,3000,0.00018754688672168043,0.006334800040349364,1000,2074
MMG,4000,3000,0.00018754688672168043,1.8311376001220196,1000,2074
SoA heuristic,4020,3015,0.00018661358546902214,0.006348199909552932,1005,2004
MMG,4020,3015,0.00018661358546902214,1.7318641999736428,1005,2004
SoA heuristic,4040,3030,0.00018568952711067095,0.002095300005748868,1010,2053
MMG,4040,3030,0.00018568952711067095,1.8949450999498367,1010,2053
SoA heuristic,4080,3060,0.00018386859524393233,0.0061935000121593475,1020,2038
MMG,4080,3060,0.00018386859524393233,2.038538899971172,1020,2038
SoA heuristic,4120,3090,0.0001820830298616169,0.0077761998400092125,1030,2069
MMG,4120,3090,0.0001820830298616169,1.991173200076446,1030,2069
SoA heuristic,4200,3150,0.00017861395570373899,0.007466600043699145,1050,2158
MMG,4200,3150,0.00017861395570373899,2.002414299873635,1050,2158
SoA heuristic,4240,3180,0.00017692852087756547,0.004579599946737289,1060,2090
MMG,4240,3180,0.00017692852087756547,2.083634200040251,1060,2090
SoA heuristic,4400,3300,0.00017049329393043874,0.00220889993943274,1100,2249
MMG,4400,3300,0.00017049329393043874,2.2682200998533517,1100,2249
SoA heuristic,4600,3450,0.00016307893020221786,0.0025761998258531094,1150,2332
MMG,4600,3450,0.00016307893020221786,2.3514502998441458,1150,2332
SoA heuristic,4000,3000,0.00018754688672168043,0.005784299923107028,1000,1926
MMG,4000,3000,0.00018754688672168043,1.6911335000768304,1000,1926
SoA heuristic,4020,3015,0.00018661358546902214,0.0021422000136226416,1005,2004
MMG,4020,3015,0.00018661358546902214,1.7085957999806851,1005,2004
SoA heuristic,4040,3030,0.00018568952711067095,0.004955200012773275,1010,2112
MMG,4040,3030,0.00018568952711067095,1.7998319999314845,1010,2112
SoA heuristic,4080,3060,0.00018386859524393233,0.002344599924981594,1020,2032
MMG,4080,3060,0.00018386859524393233,1.8349506000522524,1020,2032
SoA heuristic,4120,3090,0.0001820830298616169,0.002179000061005354,1030,2056
MMG,4120,3090,0.0001820830298616169,1.9285917000379413,1030,2056
SoA heuristic,4200,3150,0.00017861395570373899,0.002144500147551298,1050,2141
MMG,4200,3150,0.00017861395570373899,2.1502443000208586,1050,2141
SoA heuristic,4240,3180,0.00017692852087756547,0.002618999918922782,1060,2062
MMG,4240,3180,0.00017692852087756547,1.8444072999991477,1060,2062
SoA heuristic,4400,3300,0.00017049329393043874,0.006076199933886528,1100,2195
MMG,4400,3300,0.00017049329393043874,2.183839099947363,1100,2195
SoA heuristic,4600,3450,0.00016307893020221786,0.0030082000885158777,1150,2286
MMG,4600,3450,0.00016307893020221786,2.235587599920109,1150,2286
SoA heuristic,4000,3000,0.00018754688672168043,0.005710599943995476,1000,2017
MMG,4000,3000,0.00018754688672168043,1.7005012000445276,1000,2017
SoA heuristic,4020,3015,0.00018661358546902214,0.009129100013524294,1005,1978
MMG,4020,3015,0.00018661358546902214,1.7928506000898778,1005,1978
SoA heuristic,4040,3030,0.00018568952711067095,0.004266300005838275,1010,1995
MMG,4040,3030,0.00018568952711067095,1.4487606000620872,1010,1995
SoA heuristic,4080,3060,0.00018386859524393233,0.0028973999433219433,1020,2117
MMG,4080,3060,0.00018386859524393233,1.7158844999503344,1020,2117
SoA heuristic,4120,3090,0.0001820830298616169,0.003944199997931719,1030,2103
MMG,4120,3090,0.0001820830298616169,1.8967067000921816,1030,2103
SoA heuristic,4200,3150,0.00017861395570373899,0.0029908998403698206,1050,2034
MMG,4200,3150,0.00017861395570373899,1.8750756001099944,1050,2034
SoA heuristic,4240,3180,0.00017692852087756547,0.0047640998382121325,1060,2103
MMG,4240,3180,0.00017692852087756547,1.914494900032878,1060,2103
SoA heuristic,4400,3300,0.00017049329393043874,0.003054200205951929,1100,2220
MMG,4400,3300,0.00017049329393043874,1.99154489999637,1100,2220
SoA heuristic,4600,3450,0.00016307893020221786,0.006763899931684136,1150,2293
MMG,4600,3450,0.00016307893020221786,2.206184499897063,1150,2293
SoA heuristic,4000,3000,0.00018754688672168043,0.0021093999966979027,1000,2013
MMG,4000,3000,0.00018754688672168043,1.5809571000281721,1000,2013
SoA heuristic,4020,3015,0.00018661358546902214,0.0027965998742729425,1005,2133
MMG,4020,3015,0.00018661358546902214,1.834034499945119,1005,2133
SoA heuristic,4040,3030,0.00018568952711067095,0.004219800001010299,1010,2040
MMG,4040,3030,0.00018568952711067095,1.7799223000183702,1010,2040
SoA heuristic,4080,3060,0.00018386859524393233,0.004741000011563301,1020,1975
MMG,4080,3060,0.00018386859524393233,1.8761746999807656,1020,1975
SoA heuristic,4120,3090,0.0001820830298616169,0.0021756000351160765,1030,2063
MMG,4120,3090,0.0001820830298616169,1.6659061000682414,1030,2063
SoA heuristic,4200,3150,0.00017861395570373899,0.04787250002846122,1050,2070
MMG,4200,3150,0.00017861395570373899,1.7952878000214696,1050,2070
SoA heuristic,4240,3180,0.00017692852087756547,0.005610200110822916,1060,2121
MMG,4240,3180,0.00017692852087756547,1.8988545001484454,1060,2121
SoA heuristic,4400,3300,0.00017049329393043874,0.005272800102829933,1100,2199
MMG,4400,3300,0.00017049329393043874,1.910773699870333,1100,2199
SoA heuristic,4600,3450,0.00016307893020221786,0.0034354999661445618,1150,2290
MMG,4600,3450,0.00016307893020221786,2.2487765001133084,1150,2290
SoA heuristic,4000,3000,0.00018754688672168043,0.0020908000878989697,1000,1982
MMG,4000,3000,0.00018754688672168043,1.851873300038278,1000,1982
SoA heuristic,4020,3015,0.00018661358546902214,0.0025706999003887177,1005,1961
MMG,4020,3015,0.00018661358546902214,1.8080561999231577,1005,1961
SoA heuristic,4040,3030,0.00018568952711067095,0.0026002998929470778,1010,1991
MMG,4040,3030,0.00018568952711067095,1.8254889999516308,1010,1991
SoA heuristic,4080,3060,0.00018386859524393233,0.02760519995354116,1020,2033
MMG,4080,3060,0.00018386859524393233,1.9307355000637472,1020,2033
SoA heuristic,4120,3090,0.0001820830298616169,0.006717300042510033,1030,2084
MMG,4120,3090,0.0001820830298616169,1.9969303000252694,1030,2084
SoA heuristic,4200,3150,0.00017861395570373899,0.006957000121474266,1050,2162
MMG,4200,3150,0.00017861395570373899,1.834937399951741,1050,2162
SoA heuristic,4240,3180,0.00017692852087756547,0.008243900025263429,1060,2143
MMG,4240,3180,0.00017692852087756547,2.0177936998661608,1060,2143
SoA heuristic,4400,3300,0.00017049329393043874,0.008317400002852082,1100,2172
MMG,4400,3300,0.00017049329393043874,2.3453730000182986,1100,2172
SoA heuristic,4600,3450,0.00016307893020221786,0.005180099979043007,1150,2337
MMG,4600,3450,0.00016307893020221786,2.3894927999936044,1150,2337
SoA heuristic,4000,3000,0.00018754688672168043,0.0025681001134216785,1000,2015
MMG,4000,3000,0.00018754688672168043,1.6496638001408428,1000,2015
SoA heuristic,4020,3015,0.00018661358546902214,0.002276299986988306,1005,2091
MMG,4020,3015,0.00018661358546902214,1.5031653998885304,1005,2091
SoA heuristic,4040,3030,0.00018568952711067095,0.002865399932488799,1010,2050
MMG,4040,3030,0.00018568952711067095,1.5791368999052793,1010,2050
SoA heuristic,4080,3060,0.00018386859524393233,0.0028989999555051327,1020,2061
MMG,4080,3060,0.00018386859524393233,1.5109709000680596,1020,2061
SoA heuristic,4120,3090,0.0001820830298616169,0.007703599985688925,1030,1986
MMG,4120,3090,0.0001820830298616169,1.7535351999104023,1030,1986
SoA heuristic,4200,3150,0.00017861395570373899,0.005311800166964531,1050,2152
MMG,4200,3150,0.00017861395570373899,1.6938865999691188,1050,2152
SoA heuristic,4240,3180,0.00017692852087756547,0.0026513999328017235,1060,2179
MMG,4240,3180,0.00017692852087756547,1.8577622999437153,1060,2179
SoA heuristic,4400,3300,0.00017049329393043874,0.006288400152698159,1100,2221
MMG,4400,3300,0.00017049329393043874,1.972570100100711,1100,2221
SoA heuristic,4600,3450,0.00016307893020221786,0.0073599000461399555,1150,2290
MMG,4600,3450,0.00016307893020221786,1.940497700124979,1150,2290
SoA heuristic,4000,3000,0.00018754688672168043,0.00580309983342886,1000,1987
MMG,4000,3000,0.00018754688672168043,1.5271006000693887,1000,1987
SoA heuristic,4020,3015,0.00018661358546902214,0.003463700180873275,1005,1993
MMG,4020,3015,0.00018661358546902214,1.6852652998641133,1005,1993
SoA heuristic,4040,3030,0.00018568952711067095,0.002076399978250265,1010,2035
MMG,4040,3030,0.00018568952711067095,1.56763910013251,1010,2035
SoA heuristic,4080,3060,0.00018386859524393233,0.027786199934780598,1020,2054
MMG,4080,3060,0.00018386859524393233,1.4851959999650717,1020,2054
SoA heuristic,4120,3090,0.0001820830298616169,0.0045611001551151276,1030,2021
MMG,4120,3090,0.0001820830298616169,1.5587190000806004,1030,2021
SoA heuristic,4200,3150,0.00017861395570373899,0.002091200090944767,1050,2078
MMG,4200,3150,0.00017861395570373899,1.7247887998819351,1050,2078
SoA heuristic,4240,3180,0.00017692852087756547,0.0030889001209288836,1060,2164
MMG,4240,3180,0.00017692852087756547,1.8461853000335395,1060,2164
SoA heuristic,4400,3300,0.00017049329393043874,0.002739200135692954,1100,2221
MMG,4400,3300,0.00017049329393043874,1.9197605999652296,1100,2221
SoA heuristic,4600,3450,0.00016307893020221786,0.00817120005376637,1150,2311
MMG,4600,3450,0.00016307893020221786,2.0870694001205266,1150,2311
SoA heuristic,4000,3000,0.00018754688672168043,0.006914299912750721,1000,2008
MMG,4000,3000,0.00018754688672168043,3.824701099889353,1000,2008
SoA heuristic,4020,3015,0.00018661358546902214,0.0074442001059651375,1005,1942
MMG,4020,3015,0.00018661358546902214,3.758133899886161,1005,1942
SoA heuristic,4040,3030,0.00018568952711067095,0.006925400113686919,1010,2063
MMG,4040,3030,0.00018568952711067095,3.7470533999148756,1010,2063
SoA heuristic,4080,3060,0.00018386859524393233,0.0073645999655127525,1020,2039
MMG,4080,3060,0.00018386859524393233,3.332026100018993,1020,2039
SoA heuristic,4120,3090,0.0001820830298616169,0.0027751000598073006,1030,2057
MMG,4120,3090,0.0001820830298616169,1.3148664000909775,1030,2057
SoA heuristic,4200,3150,0.00017861395570373899,0.002299899933859706,1050,2132
MMG,4200,3150,0.00017861395570373899,1.3109802999533713,1050,2132
SoA heuristic,4240,3180,0.00017692852087756547,0.002802200149744749,1060,2051
MMG,4240,3180,0.00017692852087756547,1.2913623000495136,1060,2051
SoA heuristic,4400,3300,0.00017049329393043874,0.002773500047624111,1100,2136
MMG,4400,3300,0.00017049329393043874,1.3832501999568194,1100,2136
SoA heuristic,4600,3450,0.00016307893020221786,0.004122500075027347,1150,2317
MMG,4600,3450,0.00016307893020221786,1.574868499999866,1150,2317
SoA heuristic,4000,3000,0.00018754688672168043,0.007054600166156888,1000,2060
MMG,4000,3000,0.00018754688672168043,3.778413000050932,1000,2060
SoA heuristic,4020,3015,0.00018661358546902214,0.007130099926143885,1005,2021
MMG,4020,3015,0.00018661358546902214,3.67450760002248,1005,2021
SoA heuristic,4040,3030,0.00018568952711067095,0.006936199963092804,1010,2043
MMG,4040,3030,0.00018568952711067095,3.703131699934602,1010,2043
SoA heuristic,4080,3060,0.00018386859524393233,0.06034659990109503,1020,2054
MMG,4080,3060,0.00018386859524393233,3.809095300035551,1020,2054
SoA heuristic,4120,3090,0.0001820830298616169,0.007201300002634525,1030,2127
MMG,4120,3090,0.0001820830298616169,4.044463899917901,1030,2127
SoA heuristic,4200,3150,0.00017861395570373899,0.007465000031515956,1050,2072
MMG,4200,3150,0.00017861395570373899,4.0717297999653965,1050,2072
SoA heuristic,4240,3180,0.00017692852087756547,0.008354600053280592,1060,2126
MMG,4240,3180,0.00017692852087756547,4.093485899968073,1060,2126
SoA heuristic,4400,3300,0.00017049329393043874,0.007939700037240982,1100,2150
MMG,4400,3300,0.00017049329393043874,4.580452300142497,1100,2150
SoA heuristic,4600,3450,0.00016307893020221786,0.009397200075909495,1150,2309
MMG,4600,3450,0.00016307893020221786,4.860933999996632,1150,2309
SoA heuristic,4000,3000,0.00018754688672168043,0.002568199997767806,1000,1944
MMG,4000,3000,0.00018754688672168043,1.137699200073257,1000,1944
SoA heuristic,4020,3015,0.00018661358546902214,0.0026996999513357878,1005,2019
MMG,4020,3015,0.00018661358546902214,1.2235490002203733,1005,2019
SoA heuristic,4040,3030,0.00018568952711067095,0.0023853001184761524,1010,2082
MMG,4040,3030,0.00018568952711067095,1.223768499912694,1010,2082
SoA heuristic,4080,3060,0.00018386859524393233,0.0023561001289635897,1020,2077
MMG,4080,3060,0.00018386859524393233,1.2382612000219524,1020,2077
SoA heuristic,4120,3090,0.0001820830298616169,0.002386499894782901,1030,2012
MMG,4120,3090,0.0001820830298616169,1.256745700025931,1030,2012
SoA heuristic,4200,3150,0.00017861395570373899,0.002912099938839674,1050,2044
MMG,4200,3150,0.00017861395570373899,1.3080232001375407,1050,2044
SoA heuristic,4240,3180,0.00017692852087756547,0.0031283001881092787,1060,2137
MMG,4240,3180,0.00017692852087756547,1.376808299915865,1060,2137
SoA heuristic,4400,3300,0.00017049329393043874,0.0024639000184834003,1100,2219
MMG,4400,3300,0.00017049329393043874,1.4410548999439925,1100,2219
SoA heuristic,4600,3450,0.00016307893020221786,0.0028627999126911163,1150,2427
MMG,4600,3450,0.00016307893020221786,1.5728223000187427,1150,2427
SoA heuristic,4000,3000,0.00018754688672168043,0.002245600102469325,1000,2030
MMG,4000,3000,0.00018754688672168043,1.1899998998269439,1000,2030
SoA heuristic,4020,3015,0.00018661358546902214,0.0027214998845010996,1005,2070
MMG,4020,3015,0.00018661358546902214,1.2214931999333203,1005,2070
SoA heuristic,4040,3030,0.00018568952711067095,0.0027522000018507242,1010,2034
MMG,4040,3030,0.00018568952711067095,1.211948499782011,1010,2034
SoA heuristic,4080,3060,0.00018386859524393233,0.0030753000173717737,1020,2039
MMG,4080,3060,0.00018386859524393233,1.2478656000457704,1020,2039
SoA heuristic,4120,3090,0.0001820830298616169,0.0024363999255001545,1030,2115
MMG,4120,3090,0.0001820830298616169,1.2631955998949707,1030,2115
SoA heuristic,4200,3150,0.00017861395570373899,0.030260399915277958,1050,2101
MMG,4200,3150,0.00017861395570373899,1.3748554000630975,1050,2101
SoA heuristic,4240,3180,0.00017692852087756547,0.0023872999008744955,1060,2146
MMG,4240,3180,0.00017692852087756547,1.3363487001042813,1060,2146
SoA heuristic,4400,3300,0.00017049329393043874,0.002628199988976121,1100,2179
MMG,4400,3300,0.00017049329393043874,1.4577446999028325,1100,2179
SoA heuristic,4600,3450,0.00016307893020221786,0.002609799848869443,1150,2289
MMG,4600,3450,0.00016307893020221786,1.5936983001884073,1150,2289
SoA heuristic,4000,3000,0.00018754688672168043,0.0022878998424857855,1000,1941
MMG,4000,3000,0.00018754688672168043,1.1925781001336873,1000,1941
SoA heuristic,4020,3015,0.00018661358546902214,0.0025066998787224293,1005,1949
MMG,4020,3015,0.00018661358546902214,1.245767000131309,1005,1949
SoA heuristic,4040,3030,0.00018568952711067095,0.0024337000213563442,1010,2092
MMG,4040,3030,0.00018568952711067095,1.221955900080502,1010,2092
SoA heuristic,4080,3060,0.00018386859524393233,0.00243760016746819,1020,2043
MMG,4080,3060,0.00018386859524393233,1.2421780999284238,1020,2043
SoA heuristic,4120,3090,0.0001820830298616169,0.02856959984637797,1030,2078
MMG,4120,3090,0.0001820830298616169,1.262023099930957,1030,2078
SoA heuristic,4200,3150,0.00017861395570373899,0.003049599938094616,1050,2079
MMG,4200,3150,0.00017861395570373899,1.317894399864599,1050,2079
SoA heuristic,4240,3180,0.00017692852087756547,0.0025100000202655792,1060,2106
MMG,4240,3180,0.00017692852087756547,1.3842229000292718,1060,2106
SoA heuristic,4400,3300,0.00017049329393043874,0.0030074999667704105,1100,2171
MMG,4400,3300,0.00017049329393043874,1.4237611000426114,1100,2171
SoA heuristic,4600,3450,0.00016307893020221786,0.002558800159022212,1150,2249
MMG,4600,3450,0.00016307893020221786,1.5533988000825047,1150,2249
SoA heuristic,4000,3000,0.00018754688672168043,0.0021867998875677586,1000,1972
MMG,4000,3000,0.00018754688672168043,1.1971138000953943,1000,1972
SoA heuristic,4020,3015,0.00018661358546902214,0.0024039000272750854,1005,1964
MMG,4020,3015,0.00018661358546902214,1.222701100166887,1005,1964
SoA heuristic,4040,3030,0.00018568952711067095,0.0026571000926196575,1010,2006
MMG,4040,3030,0.00018568952711067095,1.1929639000445604,1010,2006
SoA heuristic,4080,3060,0.00018386859524393233,0.0023041001986712217,1020,2105
MMG,4080,3060,0.00018386859524393233,1.183792700059712,1020,2105
SoA heuristic,4120,3090,0.0001820830298616169,0.028408000012859702,1030,2021
MMG,4120,3090,0.0001820830298616169,1.2762491998728365,1030,2021
SoA heuristic,4200,3150,0.00017861395570373899,0.002912800060585141,1050,2034
MMG,4200,3150,0.00017861395570373899,1.3207572000101209,1050,2034
SoA heuristic,4240,3180,0.00017692852087756547,0.002495500026270747,1060,2120
MMG,4240,3180,0.00017692852087756547,1.3461152999661863,1060,2120
SoA heuristic,4400,3300,0.00017049329393043874,0.0023145999293774366,1100,2253
MMG,4400,3300,0.00017049329393043874,1.4480667000170797,1100,2253
SoA heuristic,4600,3450,0.00016307893020221786,0.002721100114285946,1150,2329
MMG,4600,3450,0.00016307893020221786,1.6018567001447082,1150,2329
SoA heuristic,4000,3000,0.00018754688672168043,0.0029041001107543707,1000,2031
MMG,4000,3000,0.00018754688672168043,1.2026672998908907,1000,2031
SoA heuristic,4020,3015,0.00018661358546902214,0.0025385001208633184,1005,2026
MMG,4020,3015,0.00018661358546902214,1.237260099966079,1005,2026
SoA heuristic,4040,3030,0.00018568952711067095,0.002755400026217103,1010,2023
MMG,4040,3030,0.00018568952711067095,1.2130541000515223,1010,2023
SoA heuristic,4080,3060,0.00018386859524393233,0.0023440001532435417,1020,2058
MMG,4080,3060,0.00018386859524393233,1.2491460000164807,1020,2058
SoA heuristic,4120,3090,0.0001820830298616169,0.0028385999612510204,1030,2027
MMG,4120,3090,0.0001820830298616169,1.2712208998855203,1030,2027
SoA heuristic,4200,3150,0.00017861395570373899,0.0024252000730484724,1050,2171
MMG,4200,3150,0.00017861395570373899,1.277565399883315,1050,2171
SoA heuristic,4240,3180,0.00017692852087756547,0.002812999999150634,1060,2205
MMG,4240,3180,0.00017692852087756547,1.3156582999508828,1060,2205
SoA heuristic,4400,3300,0.00017049329393043874,0.0029443998355418444,1100,2250
MMG,4400,3300,0.00017049329393043874,1.4409739999100566,1100,2250
SoA heuristic,4600,3450,0.00016307893020221786,0.0026893001049757004,1150,2333
MMG,4600,3450,0.00016307893020221786,1.5912932001519948,1150,2333
SoA heuristic,4000,3000,0.00018754688672168043,0.0032791998237371445,1000,2017
MMG,4000,3000,0.00018754688672168043,1.160385899944231,1000,2017
SoA heuristic,4020,3015,0.00018661358546902214,0.0026492998003959656,1005,1941
MMG,4020,3015,0.00018661358546902214,1.1825301002245396,1005,1941
SoA heuristic,4040,3030,0.00018568952711067095,0.0023180998396128416,1010,1952
MMG,4040,3030,0.00018568952711067095,1.2183189999777824,1010,1952
SoA heuristic,4080,3060,0.00018386859524393233,0.002751300111413002,1020,2052
MMG,4080,3060,0.00018386859524393233,1.238744999980554,1020,2052
SoA heuristic,4120,3090,0.0001820830298616169,0.0023087000008672476,1030,2122
MMG,4120,3090,0.0001820830298616169,1.2596500001382083,1030,2122
SoA heuristic,4200,3150,0.00017861395570373899,0.028820500010624528,1050,2111
MMG,4200,3150,0.00017861395570373899,1.322021200088784,1050,2111
SoA heuristic,4240,3180,0.00017692852087756547,0.0031069000251591206,1060,2152
MMG,4240,3180,0.00017692852087756547,1.3256088998168707,1060,2152
SoA heuristic,4400,3300,0.00017049329393043874,0.0024071000516414642,1100,2331
MMG,4400,3300,0.00017049329393043874,1.3813511999323964,1100,2331
SoA heuristic,4600,3450,0.00016307893020221786,0.002627299865707755,1150,2258
MMG,4600,3450,0.00016307893020221786,1.5184806999750435,1150,2258
SoA heuristic,4000,3000,0.00018754688672168043,0.00280330004170537,1000,1998
MMG,4000,3000,0.00018754688672168043,1.2409405999351293,1000,1998
SoA heuristic,4020,3015,0.00018661358546902214,0.0023300000466406345,1005,1963
MMG,4020,3015,0.00018661358546902214,1.1731213999446481,1005,1963
SoA heuristic,4040,3030,0.00018568952711067095,0.0026743998751044273,1010,1975
MMG,4040,3030,0.00018568952711067095,1.2159694998990744,1010,1975
SoA heuristic,4080,3060,0.00018386859524393233,0.002352100098505616,1020,2116
MMG,4080,3060,0.00018386859524393233,1.23123349994421,1020,2116
SoA heuristic,4120,3090,0.0001820830298616169,0.0026075998321175575,1030,2068
MMG,4120,3090,0.0001820830298616169,1.2170098000206053,1030,2068
SoA heuristic,4200,3150,0.00017861395570373899,0.002513200044631958,1050,2093
MMG,4200,3150,0.00017861395570373899,1.3398436999414116,1050,2093
SoA heuristic,4240,3180,0.00017692852087756547,0.0027228998951613903,1060,2153
MMG,4240,3180,0.00017692852087756547,1.3029768001288176,1060,2153
SoA heuristic,4400,3300,0.00017049329393043874,0.002417899901047349,1100,2245
MMG,4400,3300,0.00017049329393043874,1.4619748000986874,1100,2245
SoA heuristic,4600,3450,0.00016307893020221786,0.0027338999789208174,1150,2305
MMG,4600,3450,0.00016307893020221786,1.6443137999158353,1150,2305
SoA heuristic,4000,3000,0.00018754688672168043,0.0025943999644368887,1000,2004
MMG,4000,3000,0.00018754688672168043,1.2381686000153422,1000,2004
SoA heuristic,4020,3015,0.00018661358546902214,0.002305000089108944,1005,1999
MMG,4020,3015,0.00018661358546902214,1.223346099955961,1005,1999
SoA heuristic,4040,3030,0.00018568952711067095,0.002849800046533346,1010,2002
MMG,4040,3030,0.00018568952711067095,1.2125752000138164,1010,2002
SoA heuristic,4080,3060,0.00018386859524393233,0.0023292999248951674,1020,2031
MMG,4080,3060,0.00018386859524393233,1.2099785001482815,1020,2031
SoA heuristic,4120,3090,0.0001820830298616169,0.0025439001619815826,1030,1955
MMG,4120,3090,0.0001820830298616169,1.2721416999120265,1030,1955
SoA heuristic,4200,3150,0.00017861395570373899,0.0024739999789744616,1050,2140
MMG,4200,3150,0.00017861395570373899,1.3442297000437975,1050,2140
SoA heuristic,4240,3180,0.00017692852087756547,0.002496300032362342,1060,2085
MMG,4240,3180,0.00017692852087756547,1.3441751999780536,1060,2085
SoA heuristic,4400,3300,0.00017049329393043874,0.0025549998972564936,1100,2185
MMG,4400,3300,0.00017049329393043874,1.4491294000763446,1100,2185
SoA heuristic,4600,3450,0.00016307893020221786,0.0026326999068260193,1150,2244
MMG,4600,3450,0.00016307893020221786,1.6159697999246418,1150,2244
SoA heuristic,4000,3000,0.00018754688672168043,0.002302899956703186,1000,1996
MMG,4000,3000,0.00018754688672168043,1.1748620001599193,1000,1996
SoA heuristic,4020,3015,0.00018661358546902214,0.002783200005069375,1005,1954
MMG,4020,3015,0.00018661358546902214,1.2463379998225719,1005,1954
SoA heuristic,4040,3030,0.00018568952711067095,0.0021285000257194042,1010,1983
MMG,4040,3030,0.00018568952711067095,1.2311497998889536,1010,1983
SoA heuristic,4080,3060,0.00018386859524393233,0.0024762998800724745,1020,2016
MMG,4080,3060,0.00018386859524393233,1.2554638998117298,1020,2016
SoA heuristic,4120,3090,0.0001820830298616169,0.0023188998457044363,1030,2006
MMG,4120,3090,0.0001820830298616169,1.2931017000228167,1030,2006
SoA heuristic,4200,3150,0.00017861395570373899,0.002917500212788582,1050,2117
MMG,4200,3150,0.00017861395570373899,1.383418400073424,1050,2117
SoA heuristic,4240,3180,0.00017692852087756547,0.0024252999573946,1060,2055
MMG,4240,3180,0.00017692852087756547,1.3668298001866788,1060,2055
SoA heuristic,4400,3300,0.00017049329393043874,0.0025911000557243824,1100,2133
MMG,4400,3300,0.00017049329393043874,1.4554795001167804,1100,2133
SoA heuristic,4600,3450,0.00016307893020221786,0.002826400101184845,1150,2239
MMG,4600,3450,0.00016307893020221786,1.6055959002114832,1150,2239
SoA heuristic,4000,3000,0.00018754688672168043,0.002399899996817112,1000,1976
MMG,4000,3000,0.00018754688672168043,1.219355900073424,1000,1976
SoA heuristic,4020,3015,0.00018661358546902214,0.0022507000248879194,1005,1924
MMG,4020,3015,0.00018661358546902214,1.2546635998878628,1005,1924
SoA heuristic,4040,3030,0.00018568952711067095,0.002547499956563115,1010,2078
MMG,4040,3030,0.00018568952711067095,1.292502700118348,1010,2078
SoA heuristic,4080,3060,0.00018386859524393233,0.0024419999681413174,1020,2027
MMG,4080,3060,0.00018386859524393233,1.3206468001008034,1020,2027
SoA heuristic,4120,3090,0.0001820830298616169,0.003119200002402067,1030,2006
MMG,4120,3090,0.0001820830298616169,1.358742699958384,1030,2006
SoA heuristic,4200,3150,0.00017861395570373899,0.0027341002132743597,1050,2052
MMG,4200,3150,0.00017861395570373899,1.4250747000332922,1050,2052
SoA heuristic,4240,3180,0.00017692852087756547,0.0024864000733941793,1060,2176
MMG,4240,3180,0.00017692852087756547,1.492371500004083,1060,2176
SoA heuristic,4400,3300,0.00017049329393043874,0.0025575999170541763,1100,2196
MMG,4400,3300,0.00017049329393043874,1.6026831998024136,1100,2196
SoA heuristic,4600,3450,0.00016307893020221786,0.0026312998961657286,1150,2323
MMG,4600,3450,0.00016307893020221786,1.6983358999714255,1150,2323
