name,nodes,edges,density,time,result_set,result_w
SoA heuristic,20,15,0.039473684210526314,1.8999911844730377e-05,5,24
MMG,20,15,0.039473684210526314,9.929994121193886e-05,5,24
SoA heuristic,40,30,0.019230769230769232,3.110012039542198e-05,10,95
MMG,40,30,0.019230769230769232,0.0002289998810738325,10,95
SoA heuristic,100,75,0.007575757575757576,5.9399986639618874e-05,25,664
MMG,100,75,0.007575757575757576,0.000969999935477972,25,664
SoA heuristic,200,150,0.0037688442211055275,0.00010939990170300007,50,2587
MMG,200,150,0.0037688442211055275,0.0033851000480353832,50,2587
SoA heuristic,400,300,0.0018796992481203006,0.00021749990992248058,100,9955
MMG,400,300,0.0018796992481203006,0.012610299978405237,100,9955
SoA heuristic,600,450,0.0012520868113522537,0.0003434999380260706,150,22827
MMG,600,450,0.0012520868113522537,0.027062100125476718,150,22827
SoA heuristic,1000,750,0.0007507507507507507,0.0005025998689234257,250,62595
MMG,1000,750,0.0007507507507507507,0.07459999993443489,250,62595
SoA heuristic,2000,1500,0.00037518759379689845,0.0010089999996125698,500,249103
MMG,2000,1500,0.00037518759379689845,0.28422469994984567,500,249103
SoA heuristic,4000,3000,0.00018754688672168043,0.0021781001705676317,1000,999905
MMG,4000,3000,0.00018754688672168043,1.1513807999435812,1000,999905
SoA heuristic,8000,6000,9.376172021502688e-05,0.00680680014193058,2000,4004220
MMG,8000,6000,9.376172021502688e-05,4.847202699864283,2000,4004220
SoA heuristic,20,15,0.039473684210526314,2.9700109735131264e-05,5,23
MMG,20,15,0.039473684210526314,0.00012780004180967808,5,23
SoA heuristic,40,30,0.019230769230769232,3.0399998649954796e-05,10,103
MMG,40,30,0.019230769230769232,0.0002356001641601324,10,103
SoA heuristic,100,75,0.007575757575757576,6.500002928078175e-05,25,589
MMG,100,75,0.007575757575757576,0.0009754998609423637,25,589
SoA heuristic,200,150,0.0037688442211055275,0.00011659995652735233,50,2575
MMG,200,150,0.0037688442211055275,0.0033015001099556684,50,2575
SoA heuristic,400,300,0.0018796992481203006,0.00021869991905987263,100,9953
MMG,400,300,0.0018796992481203006,0.0128262999933213,100,9953
SoA heuristic,600,450,0.0012520868113522537,0.00033609988167881966,150,22748
MMG,600,450,0.0012520868113522537,0.028534600045531988,150,22748
SoA heuristic,1000,750,0.0007507507507507507,0.0005130998324602842,250,62529
MMG,1000,750,0.0007507507507507507,0.0749536999501288,250,62529
SoA heuristic,2000,1500,0.00037518759379689845,0.0011136999819427729,500,250638
MMG,2000,1500,0.00037518759379689845,0.2934342999942601,500,250638
SoA heuristic,4000,3000,0.00018754688672168043,0.0022638000082224607,1000,1000238
MMG,4000,3000,0.00018754688672168043,1.1885150999296457,1000,1000238
SoA heuristic,8000,6000,9.376172021502688e-05,0.004969400120899081,2000,4001935
MMG,8000,6000,9.376172021502688e-05,4.621108599938452,2000,4001935
SoA heuristic,20,15,0.039473684210526314,1.9799917936325073e-05,5,23
MMG,20,15,0.039473684210526314,9.729992598295212e-05,5,23
SoA heuristic,40,30,0.019230769230769232,3.0800001695752144e-05,10,85
MMG,40,30,0.019230769230769232,0.00023719994351267815,10,85
SoA heuristic,100,75,0.007575757575757576,5.3900061175227165e-05,25,631
MMG,100,75,0.007575757575757576,0.0009073000401258469,25,631
SoA heuristic,200,150,0.0037688442211055275,0.00010799989104270935,50,2490
MMG,200,150,0.0037688442211055275,0.003359799971804023,50,2490
SoA heuristic,400,300,0.0018796992481203006,0.0002133999951183796,100,10079
MMG,400,300,0.0018796992481203006,0.012433500029146671,100,10079
SoA heuristic,600,450,0.0012520868113522537,0.000305800000205636,150,22614
MMG,600,450,0.0012520868113522537,0.027595299994572997,150,22614
SoA heuristic,1000,750,0.0007507507507507507,0.0004885001108050346,250,62656
MMG,1000,750,0.0007507507507507507,0.07361539988778532,250,62656
SoA heuristic,2000,1500,0.00037518759379689845,0.0011118999682366848,500,250629
MMG,2000,1500,0.00037518759379689845,0.2920238000806421,500,250629
SoA heuristic,4000,3000,0.00018754688672168043,0.0022502001374959946,1000,998527
MMG,4000,3000,0.00018754688672168043,1.2022204000968486,1000,998527
SoA heuristic,8000,6000,9.376172021502688e-05,0.005326900165528059,2000,4001128
MMG,8000,6000,9.376172021502688e-05,6.194991399999708,2000,4001128
SoA heuristic,20,15,0.039473684210526314,2.2399937734007835e-05,5,13
MMG,20,15,0.039473684210526314,0.00010899989865720272,5,13
SoA heuristic,40,30,0.019230769230769232,2.750009298324585e-05,10,102
MMG,40,30,0.019230769230769232,0.0002811998128890991,10,102
SoA heuristic,100,75,0.007575757575757576,0.00015050009824335575,25,613
MMG,100,75,0.007575757575757576,0.0026571000926196575,25,613
SoA heuristic,200,150,0.0037688442211055275,9.709992446005344e-05,50,2492
MMG,200,150,0.0037688442211055275,0.006860699970275164,50,2492
SoA heuristic,400,300,0.0018796992481203006,0.00018329988233745098,100,9949
MMG,400,300,0.0018796992481203006,0.012136599980294704,100,9949
SoA heuristic,600,450,0.0012520868113522537,0.00026490003801882267,150,22692
MMG,600,450,0.0012520868113522537,0.053529599914327264,150,22692
SoA heuristic,1000,750,0.0007507507507507507,0.0004521000664681196,250,62565
MMG,1000,750,0.0007507507507507507,0.1267947000451386,250,62565
SoA heuristic,2000,1500,0.00037518759379689845,0.0009957000147551298,500,249606
MMG,2000,1500,0.00037518759379689845,0.5341103000100702,500,249606
SoA heuristic,4000,3000,0.00018754688672168043,0.0029452000744640827,1000,998937
MMG,4000,3000,0.00018754688672168043,1.656936600105837,1000,998937
SoA heuristic,8000,6000,9.376172021502688e-05,0.010237299837172031,2000,3996988
MMG,8000,6000,9.376172021502688e-05,7.736932199914008,2000,3996988
SoA heuristic,20,15,0.039473684210526314,2.0099803805351257e-05,5,25
MMG,20,15,0.039473684210526314,9.320001117885113e-05,5,25
SoA heuristic,40,30,0.019230769230769232,3.700004890561104e-05,10,89
MMG,40,30,0.019230769230769232,0.0002858999650925398,10,89
SoA heuristic,100,75,0.007575757575757576,5.510007031261921e-05,25,593
MMG,100,75,0.007575757575757576,0.0008833000902086496,25,593
SoA heuristic,200,150,0.0037688442211055275,9.80000477284193e-05,50,2504
MMG,200,150,0.0037688442211055275,0.0030153999105095863,50,2504
SoA heuristic,400,300,0.0018796992481203006,0.0005638001020997763,100,9928
MMG,400,300,0.0018796992481203006,0.018135700142011046,100,9928
SoA heuristic,600,450,0.0012520868113522537,0.0005398998036980629,150,22381
MMG,600,450,0.0012520868113522537,0.038075999822467566,150,22381
SoA heuristic,1000,750,0.0007507507507507507,0.0004470997955650091,250,62526
MMG,1000,750,0.0007507507507507507,0.12128129997290671,250,62526
SoA heuristic,2000,1500,0.00037518759379689845,0.0020373999141156673,500,251102
MMG,2000,1500,0.00037518759379689845,0.46671140007674694,500,251102
SoA heuristic,4000,3000,0.00018754688672168043,0.002189300023019314,1000,1000639
MMG,4000,3000,0.00018754688672168043,1.7290447999257594,1000,1000639
SoA heuristic,8000,6000,9.376172021502688e-05,0.004775600042194128,2000,4000255
MMG,8000,6000,9.376172021502688e-05,8.031077799852937,2000,4000255
SoA heuristic,20,15,0.039473684210526314,2.1200161427259445e-05,5,20
MMG,20,15,0.039473684210526314,0.00010360009036958218,5,20
SoA heuristic,40,30,0.019230769230769232,8.579995483160019e-05,10,95
MMG,40,30,0.019230769230769232,0.000662999926134944,10,95
SoA heuristic,100,75,0.007575757575757576,7.020006887614727e-05,25,613
MMG,100,75,0.007575757575757576,0.0008969001937657595,25,613
SoA heuristic,200,150,0.0037688442211055275,0.0002644001506268978,50,2591
MMG,200,150,0.0037688442211055275,0.006960799917578697,50,2591
SoA heuristic,400,300,0.0018796992481203006,0.00018470012582838535,100,10064
MMG,400,300,0.0018796992481203006,0.01449630013667047,100,10064
SoA heuristic,600,450,0.0012520868113522537,0.0007746000774204731,150,22371
MMG,600,450,0.0012520868113522537,0.05087539996020496,150,22371
SoA heuristic,1000,750,0.0007507507507507507,0.0014198001008480787,250,62560
MMG,1000,750,0.0007507507507507507,0.11209610011428595,250,62560
SoA heuristic,2000,1500,0.00037518759379689845,0.003110900055617094,500,250791
MMG,2000,1500,0.00037518759379689845,0.44419720000587404,500,250791
SoA heuristic,4000,3000,0.00018754688672168043,0.0020310000982135534,1000,1000507
MMG,4000,3000,0.00018754688672168043,1.7837805000599474,1000,1000507
SoA heuristic,8000,6000,9.376172021502688e-05,0.006990100024268031,2000,4001598
MMG,8000,6000,9.376172021502688e-05,7.812157500069588,2000,4001598
SoA heuristic,20,15,0.039473684210526314,2.719997428357601e-05,5,25
MMG,20,15,0.039473684210526314,0.0001330999657511711,5,25
SoA heuristic,40,30,0.019230769230769232,2.8899870812892914e-05,10,107
MMG,40,30,0.019230769230769232,0.00045900000259280205,10,107
SoA heuristic,100,75,0.007575757575757576,8.530006743967533e-05,25,615
MMG,100,75,0.007575757575757576,0.0014116999227553606,25,615
SoA heuristic,200,150,0.0037688442211055275,9.560002945363522e-05,50,2433
MMG,200,150,0.0037688442211055275,0.005169800017029047,50,2433
SoA heuristic,400,300,0.0018796992481203006,0.00017950008623301983,100,9952
MMG,400,300,0.0018796992481203006,0.019898700062185526,100,9952
SoA heuristic,600,450,0.0012520868113522537,0.0002649999223649502,150,22663
MMG,600,450,0.0012520868113522537,0.04226479982025921,150,22663
SoA heuristic,1000,750,0.0007507507507507507,0.0013969000428915024,250,62404
MMG,1000,750,0.0007507507507507507,0.11537600005976856,250,62404
SoA heuristic,2000,1500,0.00037518759379689845,0.0031669000163674355,500,250503
MMG,2000,1500,0.00037518759379689845,0.4740907000377774,500,250503
SoA heuristic,4000,3000,0.00018754688672168043,0.002934299875050783,1000,1000351
MMG,4000,3000,0.00018754688672168043,2.01352580008097,1000,1000351
SoA heuristic,8000,6000,9.376172021502688e-05,0.06734169996343553,2000,4000515
MMG,8000,6000,9.376172021502688e-05,7.379934600088745,2000,4000515
SoA heuristic,20,15,0.039473684210526314,1.8900027498602867e-05,5,25
MMG,20,15,0.039473684210526314,9.019998833537102e-05,5,25
SoA heuristic,40,30,0.019230769230769232,3.800005652010441e-05,10,104
MMG,40,30,0.019230769230769232,0.00033219996839761734,10,104
SoA heuristic,100,75,0.007575757575757576,0.00016449997201561928,25,598
MMG,100,75,0.007575757575757576,0.002770999912172556,25,598
SoA heuristic,200,150,0.0037688442211055275,0.00026199989952147007,50,2537
MMG,200,150,0.0037688442211055275,0.005095999920740724,50,2537
SoA heuristic,400,300,0.0018796992481203006,0.000515699852257967,100,10064
MMG,400,300,0.0018796992481203006,0.022054099943488836,100,10064
SoA heuristic,600,450,0.0012520868113522537,0.0006093999836593866,150,22644
MMG,600,450,0.0012520868113522537,0.07001699996180832,150,22644
SoA heuristic,1000,750,0.0007507507507507507,0.000689599895849824,250,62416
MMG,1000,750,0.0007507507507507507,0.15830889996141195,250,62416
SoA heuristic,2000,1500,0.00037518759379689845,0.001904600067064166,500,250274
MMG,2000,1500,0.00037518759379689845,0.44950839993543923,500,250274
SoA heuristic,4000,3000,0.00018754688672168043,0.00209319987334311,1000,1000938
MMG,4000,3000,0.00018754688672168043,1.7903742000926286,1000,1000938
SoA heuristic,8000,6000,9.376172021502688e-05,0.054430900141596794,2000,3999545
MMG,8000,6000,9.376172021502688e-05,7.89569399994798,2000,3999545
SoA heuristic,20,15,0.039473684210526314,3.220001235604286e-05,5,29
MMG,20,15,0.039473684210526314,0.000170599902048707,5,29
SoA heuristic,40,30,0.019230769230769232,2.6899855583906174e-05,10,92
MMG,40,30,0.019230769230769232,0.00026110000908374786,10,92
SoA heuristic,100,75,0.007575757575757576,5.230004899203777e-05,25,634
MMG,100,75,0.007575757575757576,0.0008804001845419407,25,634
SoA heuristic,200,150,0.0037688442211055275,0.0002973999362438917,50,2486
MMG,200,150,0.0037688442211055275,0.00948049989528954,50,2486
SoA heuristic,400,300,0.0018796992481203006,0.00017710006795823574,100,10050
MMG,400,300,0.0018796992481203006,0.03228280018083751,100,10050
SoA heuristic,600,450,0.0012520868113522537,0.000965300016105175,150,22472
MMG,600,450,0.0012520868113522537,0.03699239995330572,150,22472
SoA heuristic,1000,750,0.0007507507507507507,0.0004509000573307276,250,62465
MMG,1000,750,0.0007507507507507507,0.09620180004276335,250,62465
SoA heuristic,2000,1500,0.00037518759379689845,0.0010081999935209751,500,249983
MMG,2000,1500,0.00037518759379689845,0.5146892000921071,500,249983
SoA heuristic,4000,3000,0.00018754688672168043,0.0020568999461829662,1000,1000163
MMG,4000,3000,0.00018754688672168043,1.9995664998423308,1000,1000163
SoA heuristic,8000,6000,9.376172021502688e-05,0.005747099872678518,2000,3999804
MMG,8000,6000,9.376172021502688e-05,7.726613400038332,2000,3999804
SoA heuristic,20,15,0.039473684210526314,6.320001557469368e-05,5,28
MMG,20,15,0.039473684210526314,0.0002951000351458788,5,28
SoA heuristic,40,30,0.019230769230769232,3.460003063082695e-05,10,92
MMG,40,30,0.019230769230769232,0.0002601000014692545,10,92
SoA heuristic,100,75,0.007575757575757576,5.719996988773346e-05,25,614
MMG,100,75,0.007575757575757576,0.0009097999427467585,25,614
SoA heuristic,200,150,0.0037688442211055275,0.000246700132265687,50,2443
MMG,200,150,0.0037688442211055275,0.013464800082147121,50,2443
SoA heuristic,400,300,0.0018796992481203006,0.00022489996626973152,100,10068
MMG,400,300,0.0018796992481203006,0.022125400137156248,100,10068
SoA heuristic,600,450,0.0012520868113522537,0.0005417999345809221,150,22550
MMG,600,450,0.0012520868113522537,0.05516739981248975,150,22550
SoA heuristic,1000,750,0.0007507507507507507,0.0004439998883754015,250,61936
MMG,1000,750,0.0007507507507507507,0.08381179999560118,250,61936
SoA heuristic,2000,1500,0.00037518759379689845,0.0017967999447137117,500,249602
MMG,2000,1500,0.00037518759379689845,0.45919249998405576,500,249602
SoA heuristic,4000,3000,0.00018754688672168043,0.0028348001651465893,1000,1000321
MMG,4000,3000,0.00018754688672168043,2.059547800105065,1000,1000321
SoA heuristic,8000,6000,9.376172021502688e-05,0.015981200151145458,2000,3996305
MMG,8000,6000,9.376172021502688e-05,7.885811799904332,2000,3996305
SoA heuristic,20,15,0.039473684210526314,5.810009315609932e-05,5,19
MMG,20,15,0.039473684210526314,0.00029939995147287846,5,19
SoA heuristic,40,30,0.019230769230769232,3.6499928683042526e-05,10,108
MMG,40,30,0.019230769230769232,0.00030170008540153503,10,108
SoA heuristic,100,75,0.007575757575757576,5.470006726682186e-05,25,612
MMG,100,75,0.007575757575757576,0.0009113000705838203,25,612
SoA heuristic,200,150,0.0037688442211055275,0.00010329997166991234,50,2484
MMG,200,150,0.0037688442211055275,0.0030324000399559736,50,2484
SoA heuristic,400,300,0.0018796992481203006,0.00018079997971653938,100,10079
MMG,400,300,0.0018796992481203006,0.026611800072714686,100,10079
SoA heuristic,600,450,0.0012520868113522537,0.0006768000312149525,150,22537
MMG,600,450,0.0012520868113522537,0.05107380007393658,150,22537
SoA heuristic,1000,750,0.0007507507507507507,0.00044070021249353886,250,62471
MMG,1000,750,0.0007507507507507507,0.12837060005404055,250,62471
SoA heuristic,2000,1500,0.00037518759379689845,0.003020599950104952,500,250021
MMG,2000,1500,0.00037518759379689845,0.47692950000055134,500,250021
SoA heuristic,4000,3000,0.00018754688672168043,0.0020375000312924385,1000,1000424
MMG,4000,3000,0.00018754688672168043,2.0130776001606137,1000,1000424
SoA heuristic,8000,6000,9.376172021502688e-05,0.06132819992490113,2000,4000840
MMG,8000,6000,9.376172021502688e-05,7.353718800004572,2000,4000840
SoA heuristic,20,15,0.039473684210526314,2.41999514400959e-05,5,22
MMG,20,15,0.039473684210526314,0.00011530006304383278,5,22
SoA heuristic,40,30,0.019230769230769232,2.759997732937336e-05,10,107
MMG,40,30,0.019230769230769232,0.00023459992371499538,10,107
SoA heuristic,100,75,0.007575757575757576,5.369982682168484e-05,25,677
MMG,100,75,0.007575757575757576,0.000906399916857481,25,677
SoA heuristic,200,150,0.0037688442211055275,0.0003570001572370529,50,2445
MMG,200,150,0.0037688442211055275,0.014592300169169903,50,2445
SoA heuristic,400,300,0.0018796992481203006,0.0001852000132203102,100,10063
MMG,400,300,0.0018796992481203006,0.011225000023841858,100,10063
SoA heuristic,600,450,0.0012520868113522537,0.0002967000473290682,150,22568
MMG,600,450,0.0012520868113522537,0.047745299991220236,150,22568
SoA heuristic,1000,750,0.0007507507507507507,0.00045900000259280205,250,62132
MMG,1000,750,0.0007507507507507507,0.1136228998657316,250,62132
SoA heuristic,2000,1500,0.00037518759379689845,0.0014020998496562243,500,249896
MMG,2000,1500,0.00037518759379689845,0.43383449991233647,500,249896
SoA heuristic,4000,3000,0.00018754688672168043,0.0020311998669058084,1000,1001388
MMG,4000,3000,0.00018754688672168043,2.0527369999326766,1000,1001388
SoA heuristic,8000,6000,9.376172021502688e-05,0.0075756998267024755,2000,3998792
MMG,8000,6000,9.376172021502688e-05,7.532918800134212,2000,3998792
SoA heuristic,20,15,0.039473684210526314,1.8800143152475357e-05,5,15
MMG,20,15,0.039473684210526314,9.269989095628262e-05,5,15
SoA heuristic,40,30,0.019230769230769232,3.729993477463722e-05,10,102
MMG,40,30,0.019230769230769232,0.00030310009606182575,10,102
SoA heuristic,100,75,0.007575757575757576,0.00011190003715455532,25,602
MMG,100,75,0.007575757575757576,0.0010806999634951353,25,602
SoA heuristic,200,150,0.0037688442211055275,0.0003065001219511032,50,2509
MMG,200,150,0.0037688442211055275,0.009770199889317155,50,2509
SoA heuristic,400,300,0.0018796992481203006,0.0006238999776542187,100,9926
MMG,400,300,0.0018796992481203006,0.03725240007042885,100,9926
SoA heuristic,600,450,0.0012520868113522537,0.0002799998037517071,150,22334
MMG,600,450,0.0012520868113522537,0.03466060012578964,150,22334
SoA heuristic,1000,750,0.0007507507507507507,0.00045219995081424713,250,62572
MMG,1000,750,0.0007507507507507507,0.08543029986321926,250,62572
SoA heuristic,2000,1500,0.00037518759379689845,0.002566999988630414,500,250416
MMG,2000,1500,0.00037518759379689845,0.4941549999639392,500,250416
SoA heuristic,4000,3000,0.00018754688672168043,0.002064500004053116,1000,1000199
MMG,4000,3000,0.00018754688672168043,1.74710309994407,1000,1000199
SoA heuristic,8000,6000,9.376172021502688e-05,0.0050995999481529,2000,4003637
MMG,8000,6000,9.376172021502688e-05,7.642543199937791,2000,4003637
SoA heuristic,20,15,0.039473684210526314,2.9399991035461426e-05,5,17
MMG,20,15,0.039473684210526314,0.00012739980593323708,5,17
SoA heuristic,40,30,0.019230769230769232,3.150012344121933e-05,10,99
MMG,40,30,0.019230769230769232,0.0002576000988483429,10,99
SoA heuristic,100,75,0.007575757575757576,5.8999983593821526e-05,25,621
MMG,100,75,0.007575757575757576,0.0009089000523090363,25,621
SoA heuristic,200,150,0.0037688442211055275,9.740004315972328e-05,50,2559
MMG,200,150,0.0037688442211055275,0.0030048999469727278,50,2559
SoA heuristic,400,300,0.0018796992481203006,0.000565999886021018,100,10013
MMG,400,300,0.0018796992481203006,0.03342039999552071,100,10013
SoA heuristic,600,450,0.0012520868113522537,0.0009299998637288809,150,22540
MMG,600,450,0.0012520868113522537,0.058905000099912286,150,22540
SoA heuristic,1000,750,0.0007507507507507507,0.00045020016841590405,250,62457
MMG,1000,750,0.0007507507507507507,0.1228629001416266,250,62457
SoA heuristic,2000,1500,0.00037518759379689845,0.0010875000152736902,500,250766
MMG,2000,1500,0.00037518759379689845,0.4895723999943584,500,250766
SoA heuristic,4000,3000,0.00018754688672168043,0.002625799970701337,1000,999724
MMG,4000,3000,0.00018754688672168043,1.8109377999790013,1000,999724
SoA heuristic,8000,6000,9.376172021502688e-05,0.049123500008136034,2000,4002436
MMG,8000,6000,9.376172021502688e-05,7.858554899925366,2000,4002436
SoA heuristic,20,15,0.039473684210526314,4.12999652326107e-05,5,29
MMG,20,15,0.039473684210526314,0.00017889984883368015,5,29
SoA heuristic,40,30,0.019230769230769232,2.6700086891651154e-05,10,100
MMG,40,30,0.019230769230769232,0.00021389988251030445,10,100
SoA heuristic,100,75,0.007575757575757576,5.2999937906861305e-05,25,560
MMG,100,75,0.007575757575757576,0.0008916000369936228,25,560
SoA heuristic,200,150,0.0037688442211055275,0.00022529996931552887,50,2578
MMG,200,150,0.0037688442211055275,0.005334799876436591,50,2578
SoA heuristic,400,300,0.0018796992481203006,0.0002886999864131212,100,10151
MMG,400,300,0.0018796992481203006,0.02518600015901029,100,10151
SoA heuristic,600,450,0.0012520868113522537,0.0003043999895453453,150,22536
MMG,600,450,0.0012520868113522537,0.025051800068467855,150,22536
SoA heuristic,1000,750,0.0007507507507507507,0.0012870000209659338,250,62621
MMG,1000,750,0.0007507507507507507,0.14966090000234544,250,62621
SoA heuristic,2000,1500,0.00037518759379689845,0.0014062998816370964,500,251040
MMG,2000,1500,0.00037518759379689845,0.4903317999560386,500,251040
SoA heuristic,4000,3000,0.00018754688672168043,0.00692950002849102,1000,999017
MMG,4000,3000,0.00018754688672168043,1.7957044998183846,1000,999017
SoA heuristic,8000,6000,9.376172021502688e-05,0.01736900000832975,2000,4001234
MMG,8000,6000,9.376172021502688e-05,7.469306000042707,2000,4001234
SoA heuristic,20,15,0.039473684210526314,6.360001862049103e-05,5,19
MMG,20,15,0.039473684210526314,0.0002921998966485262,5,19
SoA heuristic,40,30,0.019230769230769232,2.95999925583601e-05,10,112
MMG,40,30,0.019230769230769232,0.00021580001339316368,10,112
SoA heuristic,100,75,0.007575757575757576,5.520018748939037e-05,25,623
MMG,100,75,0.007575757575757576,0.001491899834945798,25,623
SoA heuristic,200,150,0.0037688442211055275,0.00032650004141032696,50,2550
MMG,200,150,0.0037688442211055275,0.006007299991324544,50,2550
SoA heuristic,400,300,0.0018796992481203006,0.0005705999210476875,100,9970
MMG,400,300,0.0018796992481203006,0.020633599953725934,100,9970
SoA heuristic,600,450,0.0012520868113522537,0.00026899995282292366,150,22436
MMG,600,450,0.0012520868113522537,0.06533980020321906,150,22436
SoA heuristic,1000,750,0.0007507507507507507,0.0013687999453395605,250,62158
MMG,1000,750,0.0007507507507507507,0.09107779990881681,250,62158
SoA heuristic,2000,1500,0.00037518759379689845,0.002656299853697419,500,249416
MMG,2000,1500,0.00037518759379689845,0.5258580998051912,500,249416
SoA heuristic,4000,3000,0.00018754688672168043,0.0020488000009208918,1000,1001127
MMG,4000,3000,0.00018754688672168043,1.8919133997987956,1000,1001127
SoA heuristic,8000,6000,9.376172021502688e-05,0.004805200034752488,2000,4000862
MMG,8000,6000,9.376172021502688e-05,7.734284099889919,2000,4000862
SoA heuristic,20,15,0.039473684210526314,3.809994086623192e-05,5,19
MMG,20,15,0.039473684210526314,0.0001705000177025795,5,19
SoA heuristic,40,30,0.019230769230769232,3.360002301633358e-05,10,94
MMG,40,30,0.019230769230769232,0.000278000021353364,10,94
SoA heuristic,100,75,0.007575757575757576,5.469983443617821e-05,25,606
MMG,100,75,0.007575757575757576,0.0010275000240653753,25,606
SoA heuristic,200,150,0.0037688442211055275,0.00030010007321834564,50,2529
MMG,200,150,0.0037688442211055275,0.008420499972999096,50,2529
SoA heuristic,400,300,0.0018796992481203006,0.0005663000047206879,100,10117
MMG,400,300,0.0018796992481203006,0.023834299994632602,100,10117
SoA heuristic,600,450,0.0012520868113522537,0.00026979995891451836,150,22457
MMG,600,450,0.0012520868113522537,0.053983999881893396,150,22457
SoA heuristic,1000,750,0.0007507507507507507,0.0014947999734431505,250,62781
MMG,1000,750,0.0007507507507507507,0.1300987999420613,250,62781
SoA heuristic,2000,1500,0.00037518759379689845,0.001945599913597107,500,250003
MMG,2000,1500,0.00037518759379689845,0.49737949995324016,500,250003
SoA heuristic,4000,3000,0.00018754688672168043,0.003908900078386068,1000,1001330
MMG,4000,3000,0.00018754688672168043,2.0543074999004602,1000,1001330
SoA heuristic,8000,6000,9.376172021502688e-05,0.004950400209054351,2000,3997145
MMG,8000,6000,9.376172021502688e-05,7.550517200026661,2000,3997145
SoA heuristic,20,15,0.039473684210526314,2.019992098212242e-05,5,32
MMG,20,15,0.039473684210526314,9.079999290406704e-05,5,32
SoA heuristic,40,30,0.019230769230769232,3.390014171600342e-05,10,81
MMG,40,30,0.019230769230769232,0.00023419992066919804,10,81
SoA heuristic,100,75,0.007575757575757576,0.00015789992175996304,25,627
MMG,100,75,0.007575757575757576,0.0025843000039458275,25,627
SoA heuristic,200,150,0.0037688442211055275,0.00016579986549913883,50,2480
MMG,200,150,0.0037688442211055275,0.004820300033316016,50,2480
SoA heuristic,400,300,0.0018796992481203006,0.0001854998990893364,100,10026
MMG,400,300,0.0018796992481203006,0.0197242998983711,100,10026
SoA heuristic,600,450,0.0012520868113522537,0.0008328000549226999,150,22669
MMG,600,450,0.0012520868113522537,0.048887599958106875,150,22669
SoA heuristic,1000,750,0.0007507507507507507,0.00045330007560551167,250,62553
MMG,1000,750,0.0007507507507507507,0.0937731999438256,250,62553
SoA heuristic,2000,1500,0.00037518759379689845,0.0028750000055879354,500,250336
MMG,2000,1500,0.00037518759379689845,0.3726172000169754,500,250336
SoA heuristic,4000,3000,0.00018754688672168043,0.0020285998471081257,1000,1001122
MMG,4000,3000,0.00018754688672168043,2.0937494998797774,1000,1001122
SoA heuristic,8000,6000,9.376172021502688e-05,0.004658600082620978,2000,3995418
MMG,8000,6000,9.376172021502688e-05,7.4516393998637795,2000,3995418
SoA heuristic,20,15,0.039473684210526314,1.9300030544400215e-05,5,28
MMG,20,15,0.039473684210526314,9.330012835562229e-05,5,28
SoA heuristic,40,30,0.019230769230769232,5.1800161600112915e-05,10,100
MMG,40,30,0.019230769230769232,0.00022400007583200932,10,100
SoA heuristic,100,75,0.007575757575757576,5.429983139038086e-05,25,627
MMG,100,75,0.007575757575757576,0.0009212000295519829,25,627
SoA heuristic,200,150,0.0037688442211055275,9.600003249943256e-05,50,2415
MMG,200,150,0.0037688442211055275,0.006736400071531534,50,2415
SoA heuristic,400,300,0.0018796992481203006,0.0005521001294255257,100,10033
MMG,400,300,0.0018796992481203006,0.019958300050348043,100,10033
SoA heuristic,600,450,0.0012520868113522537,0.0009673000313341618,150,22526
MMG,600,450,0.0012520868113522537,0.0703551999758929,150,22526
SoA heuristic,1000,750,0.0007507507507507507,0.00045199994929134846,250,62223
MMG,1000,750,0.0007507507507507507,0.11825729999691248,250,62223
SoA heuristic,2000,1500,0.00037518759379689845,0.0033295999746769667,500,249583
MMG,2000,1500,0.00037518759379689845,0.4811843999195844,500,249583
SoA heuristic,4000,3000,0.00018754688672168043,0.006194300018250942,1000,999777
MMG,4000,3000,0.00018754688672168043,2.0026747998781502,1000,999777
SoA heuristic,8000,6000,9.376172021502688e-05,0.004893400007858872,2000,4003734
MMG,8000,6000,9.376172021502688e-05,7.938927999930456,2000,4003734
SoA heuristic,20,15,0.039473684210526314,6.21001236140728e-05,5,17
MMG,20,15,0.039473684210526314,0.0003582998178899288,5,17
SoA heuristic,40,30,0.019230769230769232,9.610014967620373e-05,10,116
MMG,40,30,0.019230769230769232,0.0006674998439848423,10,116
SoA heuristic,100,75,0.007575757575757576,5.439994856715202e-05,25,641
MMG,100,75,0.007575757575757576,0.0009282000828534365,25,641
SoA heuristic,200,150,0.0037688442211055275,9.840005077421665e-05,50,2421
MMG,200,150,0.0037688442211055275,0.0051443001721054316,50,2421
SoA heuristic,400,300,0.0018796992481203006,0.00018179998733103275,100,10100
MMG,400,300,0.0018796992481203006,0.022251300048083067,100,10100
SoA heuristic,600,450,0.0012520868113522537,0.00035009998828172684,150,22817
MMG,600,450,0.0012520868113522537,0.05485840002074838,150,22817
SoA heuristic,1000,750,0.0007507507507507507,0.0008892000187188387,250,62479
MMG,1000,750,0.0007507507507507507,0.09610769990831614,250,62479
SoA heuristic,2000,1500,0.00037518759379689845,0.001519199926406145,500,249768
MMG,2000,1500,0.00037518759379689845,0.4430138999596238,500,249768
SoA heuristic,4000,3000,0.00018754688672168043,0.0025307999458163977,1000,1000433
MMG,4000,3000,0.00018754688672168043,1.8744163000956178,1000,1000433
SoA heuristic,8000,6000,9.376172021502688e-05,0.011775200022384524,2000,3999537
MMG,8000,6000,9.376172021502688e-05,7.449655199889094,2000,3999537
SoA heuristic,20,15,0.039473684210526314,2.1999934688210487e-05,5,19
MMG,20,15,0.039473684210526314,0.00010040006600320339,5,19
SoA heuristic,40,30,0.019230769230769232,2.7799978852272034e-05,10,92
MMG,40,30,0.019230769230769232,0.00022039981558918953,10,92
SoA heuristic,100,75,0.007575757575757576,5.5999960750341415e-05,25,674
MMG,100,75,0.007575757575757576,0.0009190000128000975,25,674
SoA heuristic,200,150,0.0037688442211055275,0.00010569998994469643,50,2448
MMG,200,150,0.0037688442211055275,0.005058499984443188,50,2448
SoA heuristic,400,300,0.0018796992481203006,0.0005487001035362482,100,10078
MMG,400,300,0.0018796992481203006,0.014916999964043498,100,10078
SoA heuristic,600,450,0.0012520868113522537,0.0002725999802350998,150,22511
MMG,600,450,0.0012520868113522537,0.026046600192785263,150,22511
SoA heuristic,1000,750,0.0007507507507507507,0.0013681999407708645,250,62152
MMG,1000,750,0.0007507507507507507,0.11506119999103248,250,62152
SoA heuristic,2000,1500,0.00037518759379689845,0.001013800036162138,500,250632
MMG,2000,1500,0.00037518759379689845,0.4102199000772089,500,250632
SoA heuristic,4000,3000,0.00018754688672168043,0.004691499983891845,1000,999992
MMG,4000,3000,0.00018754688672168043,1.8898928000126034,1000,999992
SoA heuristic,8000,6000,9.376172021502688e-05,0.007253699935972691,2000,3999925
MMG,8000,6000,9.376172021502688e-05,7.784641599981114,2000,3999925
SoA heuristic,20,15,0.039473684210526314,1.910002902150154e-05,5,25
MMG,20,15,0.039473684210526314,8.989986963570118e-05,5,25
SoA heuristic,40,30,0.019230769230769232,2.8299866244196892e-05,10,82
MMG,40,30,0.019230769230769232,0.00022089993581175804,10,82
SoA heuristic,100,75,0.007575757575757576,0.00016380008310079575,25,672
MMG,100,75,0.007575757575757576,0.0027944999746978283,25,672
SoA heuristic,200,150,0.0037688442211055275,0.0001784998457878828,50,2418
MMG,200,150,0.0037688442211055275,0.004257899941876531,50,2418
SoA heuristic,400,300,0.0018796992481203006,0.00018079997971653938,100,9923
MMG,400,300,0.0018796992481203006,0.010991499992087483,100,9923
SoA heuristic,600,450,0.0012520868113522537,0.0002850999590009451,150,22455
MMG,600,450,0.0012520868113522537,0.06047439994290471,150,22455
SoA heuristic,1000,750,0.0007507507507507507,0.00044519989751279354,250,62294
MMG,1000,750,0.0007507507507507507,0.09988680016249418,250,62294
SoA heuristic,2000,1500,0.00037518759379689845,0.0033720999490469694,500,249597
MMG,2000,1500,0.00037518759379689845,0.4810301000252366,500,249597
SoA heuristic,4000,3000,0.00018754688672168043,0.0022889000829309225,1000,1000424
MMG,4000,3000,0.00018754688672168043,1.9945190001744777,1000,1000424
SoA heuristic,8000,6000,9.376172021502688e-05,0.009265900123864412,2000,3996446
MMG,8000,6000,9.376172021502688e-05,7.6601749998517334,2000,3996446
SoA heuristic,20,15,0.039473684210526314,6.730016320943832e-05,5,15
MMG,20,15,0.039473684210526314,0.00028440007008612156,5,15
SoA heuristic,40,30,0.019230769230769232,8.370005525648594e-05,10,100
MMG,40,30,0.019230769230769232,0.0006756000220775604,10,100
SoA heuristic,100,75,0.007575757575757576,0.00029250001534819603,25,634
MMG,100,75,0.007575757575757576,0.0028955000452697277,25,634
SoA heuristic,200,150,0.0037688442211055275,0.00010349997319281101,50,2482
MMG,200,150,0.0037688442211055275,0.005782900145277381,50,2482
SoA heuristic,400,300,0.0018796992481203006,0.0001821999903768301,100,10033
MMG,400,300,0.0018796992481203006,0.022230900125578046,100,10033
SoA heuristic,600,450,0.0012520868113522537,0.00028549996204674244,150,22729
MMG,600,450,0.0012520868113522537,0.03424740000627935,150,22729
SoA heuristic,1000,750,0.0007507507507507507,0.001409200020134449,250,62359
MMG,1000,750,0.0007507507507507507,0.1434106999076903,250,62359
SoA heuristic,2000,1500,0.00037518759379689845,0.0031967000104486942,500,249449
MMG,2000,1500,0.00037518759379689845,0.4525420998688787,500,249449
SoA heuristic,4000,3000,0.00018754688672168043,0.002466200152412057,1000,999634
MMG,4000,3000,0.00018754688672168043,1.7591640001628548,1000,999634
SoA heuristic,8000,6000,9.376172021502688e-05,0.010520500130951405,2000,4000617
MMG,8000,6000,9.376172021502688e-05,7.968642899999395,2000,4000617
SoA heuristic,20,15,0.039473684210526314,2.0700041204690933e-05,5,30
MMG,20,15,0.039473684210526314,9.389990009367466e-05,5,30
SoA heuristic,40,30,0.019230769230769232,2.71000899374485e-05,10,97
MMG,40,30,0.019230769230769232,0.0002202000468969345,10,97
SoA heuristic,100,75,0.007575757575757576,5.320017226040363e-05,25,687
MMG,100,75,0.007575757575757576,0.0008954999502748251,25,687
SoA heuristic,200,150,0.0037688442211055275,9.66999214142561e-05,50,2497
MMG,200,150,0.0037688442211055275,0.0029968000017106533,50,2497
SoA heuristic,400,300,0.0018796992481203006,0.00017779995687305927,100,9888
MMG,400,300,0.0018796992481203006,0.012874700129032135,100,9888
SoA heuristic,600,450,0.0012520868113522537,0.00026860018260776997,150,22659
MMG,600,450,0.0012520868113522537,0.032871900126338005,150,22659
SoA heuristic,1000,750,0.0007507507507507507,0.0007340000011026859,250,62363
MMG,1000,750,0.0007507507507507507,0.10414019995369017,250,62363
SoA heuristic,2000,1500,0.00037518759379689845,0.0014730000402778387,500,250425
MMG,2000,1500,0.00037518759379689845,0.49831300019286573,500,250425
SoA heuristic,4000,3000,0.00018754688672168043,0.00432930001989007,1000,1000289
MMG,4000,3000,0.00018754688672168043,1.8280762999784201,1000,1000289
SoA heuristic,8000,6000,9.376172021502688e-05,0.004346400033682585,2000,4001019
MMG,8000,6000,9.376172021502688e-05,7.112664399901405,2000,4001019
SoA heuristic,20,15,0.039473684210526314,1.840014010667801e-05,5,24
MMG,20,15,0.039473684210526314,9.200000204145908e-05,5,24
SoA heuristic,40,30,0.019230769230769232,2.8099864721298218e-05,10,102
MMG,40,30,0.019230769230769232,0.000215600011870265,10,102
SoA heuristic,100,75,0.007575757575757576,5.510007031261921e-05,25,592
MMG,100,75,0.007575757575757576,0.0019326000474393368,25,592
SoA heuristic,200,150,0.0037688442211055275,9.58999153226614e-05,50,2372
MMG,200,150,0.0037688442211055275,0.00302570010535419,50,2372
SoA heuristic,400,300,0.0018796992481203006,0.00034559983760118484,100,9987
MMG,400,300,0.0018796992481203006,0.013293000170961022,100,9987
SoA heuristic,600,450,0.0012520868113522537,0.00027279998175799847,150,22722
MMG,600,450,0.0012520868113522537,0.025054400088265538,150,22722
SoA heuristic,1000,750,0.0007507507507507507,0.0011460001114755869,250,62127
MMG,1000,750,0.0007507507507507507,0.09181030001491308,250,62127
SoA heuristic,2000,1500,0.00037518759379689845,0.00306529994122684,500,250830
MMG,2000,1500,0.00037518759379689845,0.4488597000017762,500,250830
SoA heuristic,4000,3000,0.00018754688672168043,0.007323199883103371,1000,1000697
MMG,4000,3000,0.00018754688672168043,1.9229403000790626,1000,1000697
SoA heuristic,8000,6000,9.376172021502688e-05,0.005325199803337455,2000,3997971
MMG,8000,6000,9.376172021502688e-05,7.936702699866146,2000,3997971
SoA heuristic,20,15,0.039473684210526314,2.269982360303402e-05,5,25
MMG,20,15,0.039473684210526314,9.609991684556007e-05,5,25
SoA heuristic,40,30,0.019230769230769232,2.7899863198399544e-05,10,82
MMG,40,30,0.019230769230769232,0.00022199982777237892,10,82
SoA heuristic,100,75,0.007575757575757576,0.0001642999704927206,25,616
MMG,100,75,0.007575757575757576,0.0025752000510692596,25,616
SoA heuristic,200,150,0.0037688442211055275,0.0002832000609487295,50,2531
MMG,200,150,0.0037688442211055275,0.008748900145292282,50,2531
SoA heuristic,400,300,0.0018796992481203006,0.0005319998599588871,100,10035
MMG,400,300,0.0018796992481203006,0.024299100041389465,100,10035
SoA heuristic,600,450,0.0012520868113522537,0.0007254001684486866,150,22802
MMG,600,450,0.0012520868113522537,0.038607999915257096,150,22802
SoA heuristic,1000,750,0.0007507507507507507,0.0004642999265342951,250,62381
MMG,1000,750,0.0007507507507507507,0.14662240003235638,250,62381
SoA heuristic,2000,1500,0.00037518759379689845,0.0010430000256747007,500,250549
MMG,2000,1500,0.00037518759379689845,0.453404099913314,500,250549
SoA heuristic,4000,3000,0.00018754688672168043,0.004702300066128373,1000,1000134
MMG,4000,3000,0.00018754688672168043,1.8105941999237984,1000,1000134
SoA heuristic,8000,6000,9.376172021502688e-05,0.0049189000856131315,2000,3998805
MMG,8000,6000,9.376172021502688e-05,7.343003200134262,2000,3998805
SoA heuristic,20,15,0.039473684210526314,1.919991336762905e-05,5,24
MMG,20,15,0.039473684210526314,9.380001574754715e-05,5,24
SoA heuristic,40,30,0.019230769230769232,2.8099864721298218e-05,10,107
MMG,40,30,0.019230769230769232,0.00022469996474683285,10,107
SoA heuristic,100,75,0.007575757575757576,5.439994856715202e-05,25,671
MMG,100,75,0.007575757575757576,0.0008876000065356493,25,671
SoA heuristic,200,150,0.0037688442211055275,9.580003097653389e-05,50,2511
MMG,200,150,0.0037688442211055275,0.003137199906632304,50,2511
SoA heuristic,400,300,0.0018796992481203006,0.0005379999056458473,100,9824
MMG,400,300,0.0018796992481203006,0.01749589992687106,100,9824
SoA heuristic,600,450,0.0012520868113522537,0.0007660998962819576,150,22699
MMG,600,450,0.0012520868113522537,0.06237279996275902,150,22699
SoA heuristic,1000,750,0.0007507507507507507,0.0004390999674797058,250,62694
MMG,1000,750,0.0007507507507507507,0.13752959994599223,250,62694
SoA heuristic,2000,1500,0.00037518759379689845,0.0010375999845564365,500,249800
MMG,2000,1500,0.00037518759379689845,0.3849156000651419,500,249800
SoA heuristic,4000,3000,0.00018754688672168043,0.006514000007882714,1000,1000436
MMG,4000,3000,0.00018754688672168043,1.9214935998898,1000,1000436
SoA heuristic,8000,6000,9.376172021502688e-05,0.006097699981182814,2000,3999564
MMG,8000,6000,9.376172021502688e-05,7.268911299994215,2000,3999564
SoA heuristic,20,15,0.039473684210526314,1.8800143152475357e-05,5,25
MMG,20,15,0.039473684210526314,8.999998681247234e-05,5,25
SoA heuristic,40,30,0.019230769230769232,2.5900080800056458e-05,10,103
MMG,40,30,0.019230769230769232,0.00021210010163486004,10,103
SoA heuristic,100,75,0.007575757575757576,5.359994247555733e-05,25,643
MMG,100,75,0.007575757575757576,0.0009079000446945429,25,643
SoA heuristic,200,150,0.0037688442211055275,0.00017060013487935066,50,2490
MMG,200,150,0.0037688442211055275,0.004721099976450205,50,2490
SoA heuristic,400,300,0.0018796992481203006,0.0005263001658022404,100,9908
MMG,400,300,0.0018796992481203006,0.01709460001438856,100,9908
SoA heuristic,600,450,0.0012520868113522537,0.0002828999422490597,150,22509
MMG,600,450,0.0012520868113522537,0.02830139989964664,150,22509
SoA heuristic,1000,750,0.0007507507507507507,0.0013050998095422983,250,62536
MMG,1000,750,0.0007507507507507507,0.11325709987431765,250,62536
SoA heuristic,2000,1500,0.00037518759379689845,0.0010005999356508255,500,249827
MMG,2000,1500,0.00037518759379689845,0.4463910998310894,500,249827
SoA heuristic,4000,3000,0.00018754688672168043,0.0024217001628130674,1000,999921
MMG,4000,3000,0.00018754688672168043,1.7522130999714136,1000,999921
SoA heuristic,8000,6000,9.376172021502688e-05,0.014056199928745627,2000,3999012
MMG,8000,6000,9.376172021502688e-05,7.667272899998352,2000,3999012
SoA heuristic,20,15,0.039473684210526314,3.0800001695752144e-05,5,23
MMG,20,15,0.039473684210526314,0.0001626999583095312,5,23
SoA heuristic,40,30,0.019230769230769232,2.8300099074840546e-05,10,91
MMG,40,30,0.019230769230769232,0.00022149994038045406,10,91
SoA heuristic,100,75,0.007575757575757576,0.00017739995382726192,25,650
MMG,100,75,0.007575757575757576,0.002920399885624647,25,650
SoA heuristic,200,150,0.0037688442211055275,0.00010040006600320339,50,2545
MMG,200,150,0.0037688442211055275,0.0030164001509547234,50,2545
SoA heuristic,400,300,0.0018796992481203006,0.0002530999481678009,100,9876
MMG,400,300,0.0018796992481203006,0.012336499989032745,100,9876
SoA heuristic,600,450,0.0012520868113522537,0.00028060004115104675,150,22613
MMG,600,450,0.0012520868113522537,0.055377099895849824,150,22613
SoA heuristic,1000,750,0.0007507507507507507,0.000727199949324131,250,62424
MMG,1000,750,0.0007507507507507507,0.10710879997350276,250,62424
SoA heuristic,2000,1500,0.00037518759379689845,0.0012487999629229307,500,249693
MMG,2000,1500,0.00037518759379689845,0.47488869982771575,500,249693
SoA heuristic,4000,3000,0.00018754688672168043,0.004511100007221103,1000,998948
MMG,4000,3000,0.00018754688672168043,1.6050724999513477,1000,998948
SoA heuristic,8000,6000,9.376172021502688e-05,0.015147600090131164,2000,3999915
MMG,8000,6000,9.376172021502688e-05,7.6487857000902295,2000,3999915
