name,nodes,edges,density,time,result_set,result_w
SoA heuristic,20,15,0.039473684210526314,2.519995905458927e-05,5,9
MMG,20,15,0.039473684210526314,8.859997615218163e-05,5,9
SoA heuristic,40,30,0.019230769230769232,2.859998494386673e-05,10,23
MMG,40,30,0.019230769230769232,0.00021740002557635307,10,23
SoA heuristic,100,75,0.007575757575757576,5.759997293353081e-05,25,53
MMG,100,75,0.007575757575757576,0.0009828999172896147,25,53
SoA heuristic,200,150,0.0037688442211055275,0.00010790000669658184,50,90
MMG,200,150,0.0037688442211055275,0.003474100027233362,50,90
SoA heuristic,400,300,0.0018796992481203006,0.00020020012743771076,100,195
MMG,400,300,0.0018796992481203006,0.01262459997087717,100,195
SoA heuristic,600,450,0.0012520868113522537,0.0003100999165326357,150,283
MMG,600,450,0.0012520868113522537,0.02810740005224943,150,283
SoA heuristic,1000,750,0.0007507507507507507,0.000514900078997016,250,525
MMG,1000,750,0.0007507507507507507,0.07553760008886456,250,525
SoA heuristic,2000,1500,0.00037518759379689845,0.001132899895310402,500,1013
MMG,2000,1500,0.00037518759379689845,0.29832750000059605,500,1013
SoA heuristic,4000,3000,0.00018754688672168043,0.002134700072929263,1000,2107
MMG,4000,3000,0.00018754688672168043,1.159034099895507,1000,2107
SoA heuristic,8000,6000,9.376172021502688e-05,0.005131799960508943,2000,3946
MMG,8000,6000,9.376172021502688e-05,4.766944000031799,2000,3946
SoA heuristic,20,15,0.039473684210526314,1.9999919459223747e-05,5,15
MMG,20,15,0.039473684210526314,9.590014815330505e-05,5,15
SoA heuristic,40,30,0.019230769230769232,3.1299889087677e-05,10,28
MMG,40,30,0.019230769230769232,0.0002413999754935503,10,28
SoA heuristic,100,75,0.007575757575757576,5.729985423386097e-05,25,58
MMG,100,75,0.007575757575757576,0.0009306001011282206,25,58
SoA heuristic,200,150,0.0037688442211055275,0.00010779988951981068,50,102
MMG,200,150,0.0037688442211055275,0.00341070001013577,50,102
SoA heuristic,400,300,0.0018796992481203006,0.0002087999600917101,100,211
MMG,400,300,0.0018796992481203006,0.012692899908870459,100,211
SoA heuristic,600,450,0.0012520868113522537,0.0003060000017285347,150,303
MMG,600,450,0.0012520868113522537,0.02763490006327629,150,303
SoA heuristic,1000,750,0.0007507507507507507,0.000470499973744154,250,543
MMG,1000,750,0.0007507507507507507,0.07242390001192689,250,543
SoA heuristic,2000,1500,0.00037518759379689845,0.0011379001662135124,500,955
MMG,2000,1500,0.00037518759379689845,0.29460779996588826,500,955
SoA heuristic,4000,3000,0.00018754688672168043,0.0020692998077720404,1000,1950
MMG,4000,3000,0.00018754688672168043,1.1355302000883967,1000,1950
SoA heuristic,8000,6000,9.376172021502688e-05,0.005216000135987997,2000,3939
MMG,8000,6000,9.376172021502688e-05,4.808173399884254,2000,3939
SoA heuristic,20,15,0.039473684210526314,1.919991336762905e-05,5,16
MMG,20,15,0.039473684210526314,9.600003249943256e-05,5,16
SoA heuristic,40,30,0.019230769230769232,2.7499860152602196e-05,10,19
MMG,40,30,0.019230769230769232,0.00022610020823776722,10,19
SoA heuristic,100,75,0.007575757575757576,5.5999960750341415e-05,25,64
MMG,100,75,0.007575757575757576,0.0009350001346319914,25,64
SoA heuristic,200,150,0.0037688442211055275,0.00010770000517368317,50,109
MMG,200,150,0.0037688442211055275,0.0034117999020963907,50,109
SoA heuristic,400,300,0.0018796992481203006,0.00021029985509812832,100,216
MMG,400,300,0.0018796992481203006,0.012698200065642595,100,216
SoA heuristic,600,450,0.0012520868113522537,0.00028760009445250034,150,296
MMG,600,450,0.0012520868113522537,0.027599100023508072,150,296
SoA heuristic,1000,750,0.0007507507507507507,0.0005116001702845097,250,513
MMG,1000,750,0.0007507507507507507,0.07516160001978278,250,513
SoA heuristic,2000,1500,0.00037518759379689845,0.0010997999925166368,500,1029
MMG,2000,1500,0.00037518759379689845,0.2975021998863667,500,1029
SoA heuristic,4000,3000,0.00018754688672168043,0.00224910001270473,1000,1965
MMG,4000,3000,0.00018754688672168043,1.1956285000778735,1000,1965
SoA heuristic,8000,6000,9.376172021502688e-05,0.005647000158205628,2000,3945
MMG,8000,6000,9.376172021502688e-05,4.868582299910486,2000,3945
SoA heuristic,20,15,0.039473684210526314,1.950003206729889e-05,5,14
MMG,20,15,0.039473684210526314,9.430013597011566e-05,5,14
SoA heuristic,40,30,0.019230769230769232,2.750009298324585e-05,10,21
MMG,40,30,0.019230769230769232,0.0002209001686424017,10,21
SoA heuristic,100,75,0.007575757575757576,5.770009011030197e-05,25,43
MMG,100,75,0.007575757575757576,0.0009963999036699533,25,43
SoA heuristic,200,150,0.0037688442211055275,0.00010050018317997456,50,91
MMG,200,150,0.0037688442211055275,0.0032697999849915504,50,91
SoA heuristic,400,300,0.0018796992481203006,0.00020709983073174953,100,219
MMG,400,300,0.0018796992481203006,0.01266180002130568,100,219
SoA heuristic,600,450,0.0012520868113522537,0.0003021999727934599,150,301
MMG,600,450,0.0012520868113522537,0.027930699987336993,150,301
SoA heuristic,1000,750,0.0007507507507507507,0.0005099000409245491,250,505
MMG,1000,750,0.0007507507507507507,0.07655279990285635,250,505
SoA heuristic,2000,1500,0.00037518759379689845,0.0011226001661270857,500,999
MMG,2000,1500,0.00037518759379689845,0.29832500009797513,500,999
SoA heuristic,4000,3000,0.00018754688672168043,0.02242870000191033,1000,1986
MMG,4000,3000,0.00018754688672168043,1.209341400070116,1000,1986
SoA heuristic,8000,6000,9.376172021502688e-05,0.008237099973484874,2000,3902
MMG,8000,6000,9.376172021502688e-05,6.8368840999901295,2000,3902
SoA heuristic,20,15,0.039473684210526314,2.550007775425911e-05,5,10
MMG,20,15,0.039473684210526314,0.0001246999017894268,5,10
SoA heuristic,40,30,0.019230769230769232,2.8300099074840546e-05,10,20
MMG,40,30,0.019230769230769232,0.0002234999556094408,10,20
SoA heuristic,100,75,0.007575757575757576,5.570007488131523e-05,25,54
MMG,100,75,0.007575757575757576,0.001123199937865138,25,54
SoA heuristic,200,150,0.0037688442211055275,0.00010029994882643223,50,96
MMG,200,150,0.0037688442211055275,0.0031993999145925045,50,96
SoA heuristic,400,300,0.0018796992481203006,0.00027379998937249184,100,196
MMG,400,300,0.0018796992481203006,0.01668409979902208,100,196
SoA heuristic,600,450,0.0012520868113522537,0.0002761001233011484,150,321
MMG,600,450,0.0012520868113522537,0.025288600008934736,150,321
SoA heuristic,1000,750,0.0007507507507507507,0.0009633998852223158,250,470
MMG,1000,750,0.0007507507507507507,0.08809179998934269,250,470
SoA heuristic,2000,1500,0.00037518759379689845,0.001040400005877018,500,1034
MMG,2000,1500,0.00037518759379689845,0.4203923000022769,500,1034
SoA heuristic,4000,3000,0.00018754688672168043,0.0034551999997347593,1000,2039
MMG,4000,3000,0.00018754688672168043,1.5911365998908877,1000,2039
SoA heuristic,8000,6000,9.376172021502688e-05,0.004716499941423535,2000,3978
MMG,8000,6000,9.376172021502688e-05,7.556369099998847,2000,3978
SoA heuristic,20,15,0.039473684210526314,2.4900073185563087e-05,5,8
MMG,20,15,0.039473684210526314,0.00010680011473596096,5,8
SoA heuristic,40,30,0.019230769230769232,2.8199981898069382e-05,10,31
MMG,40,30,0.019230769230769232,0.00023070001043379307,10,31
SoA heuristic,100,75,0.007575757575757576,5.539995618164539e-05,25,54
MMG,100,75,0.007575757575757576,0.000916199991479516,25,54
SoA heuristic,200,150,0.0037688442211055275,0.00010549998842179775,50,103
MMG,200,150,0.0037688442211055275,0.0032845998648554087,50,103
SoA heuristic,400,300,0.0018796992481203006,0.00020059989765286446,100,223
MMG,400,300,0.0018796992481203006,0.012426800094544888,100,223
SoA heuristic,600,450,0.0012520868113522537,0.00031409994699060917,150,321
MMG,600,450,0.0012520868113522537,0.026910100132226944,150,321
SoA heuristic,1000,750,0.0007507507507507507,0.00047069997526705265,250,519
MMG,1000,750,0.0007507507507507507,0.07286929991096258,250,519
SoA heuristic,2000,1500,0.00037518759379689845,0.0012836998794227839,500,1009
MMG,2000,1500,0.00037518759379689845,0.2915666000917554,500,1009
SoA heuristic,4000,3000,0.00018754688672168043,0.0022267999593168497,1000,2023
MMG,4000,3000,0.00018754688672168043,1.1795449000783265,1000,2023
SoA heuristic,8000,6000,9.376172021502688e-05,0.005085099954158068,2000,4071
MMG,8000,6000,9.376172021502688e-05,4.693613199982792,2000,4071
SoA heuristic,20,15,0.039473684210526314,2.150004729628563e-05,5,8
MMG,20,15,0.039473684210526314,0.0001091999001801014,5,8
SoA heuristic,40,30,0.019230769230769232,3.1800009310245514e-05,10,19
MMG,40,30,0.019230769230769232,0.00024090008810162544,10,19
SoA heuristic,100,75,0.007575757575757576,6.289989687502384e-05,25,48
MMG,100,75,0.007575757575757576,0.0009581998456269503,25,48
SoA heuristic,200,150,0.0037688442211055275,9.660003706812859e-05,50,105
MMG,200,150,0.0037688442211055275,0.0031636999920010567,50,105
SoA heuristic,400,300,0.0018796992481203006,0.0002041999250650406,100,185
MMG,400,300,0.0018796992481203006,0.01254469994455576,100,185
SoA heuristic,600,450,0.0012520868113522537,0.0002996001858264208,150,282
MMG,600,450,0.0012520868113522537,0.0282063998747617,150,282
SoA heuristic,1000,750,0.0007507507507507507,0.0005038001108914614,250,472
MMG,1000,750,0.0007507507507507507,0.07215470005758107,250,472
SoA heuristic,2000,1500,0.00037518759379689845,0.0011660000309348106,500,924
MMG,2000,1500,0.00037518759379689845,0.29546359996311367,500,924
SoA heuristic,4000,3000,0.00018754688672168043,0.002204099902883172,1000,1945
MMG,4000,3000,0.00018754688672168043,1.189374300185591,1000,1945
SoA heuristic,8000,6000,9.376172021502688e-05,0.00531439995393157,2000,4060
MMG,8000,6000,9.376172021502688e-05,4.671954500023276,2000,4060
SoA heuristic,20,15,0.039473684210526314,1.869979314506054e-05,5,15
MMG,20,15,0.039473684210526314,9.159999899566174e-05,5,15
SoA heuristic,40,30,0.019230769230769232,2.719997428357601e-05,10,14
MMG,40,30,0.019230769230769232,0.00022869999520480633,10,14
SoA heuristic,100,75,0.007575757575757576,5.62998466193676e-05,25,52
MMG,100,75,0.007575757575757576,0.000934600131586194,25,52
SoA heuristic,200,150,0.0037688442211055275,0.00010520010255277157,50,92
MMG,200,150,0.0037688442211055275,0.0031585998367518187,50,92
SoA heuristic,400,300,0.0018796992481203006,0.00020450004376471043,100,192
MMG,400,300,0.0018796992481203006,0.012484899954870343,100,192
SoA heuristic,600,450,0.0012520868113522537,0.00030589988455176353,150,272
MMG,600,450,0.0012520868113522537,0.027587699936702847,150,272
SoA heuristic,1000,750,0.0007507507507507507,0.0004947001580148935,250,525
MMG,1000,750,0.0007507507507507507,0.07460570009425282,250,525
SoA heuristic,2000,1500,0.00037518759379689845,0.0011660999152809381,500,987
MMG,2000,1500,0.00037518759379689845,0.2935795998200774,500,987
SoA heuristic,4000,3000,0.00018754688672168043,0.002639900194481015,1000,2023
MMG,4000,3000,0.00018754688672168043,1.1848192000761628,1000,2023
SoA heuristic,8000,6000,9.376172021502688e-05,0.0044680999126285315,2000,3972
MMG,8000,6000,9.376172021502688e-05,4.7570215000305325,2000,3972
SoA heuristic,20,15,0.039473684210526314,2.750009298324585e-05,5,7
MMG,20,15,0.039473684210526314,9.309989400207996e-05,5,7
SoA heuristic,40,30,0.019230769230769232,2.9100105166435242e-05,10,16
MMG,40,30,0.019230769230769232,0.0002327000256627798,10,16
SoA heuristic,100,75,0.007575757575757576,5.889986641705036e-05,25,45
MMG,100,75,0.007575757575757576,0.0009544000495225191,25,45
SoA heuristic,200,150,0.0037688442211055275,0.0001029998529702425,50,106
MMG,200,150,0.0037688442211055275,0.003164200112223625,50,106
SoA heuristic,400,300,0.0018796992481203006,0.00020929984748363495,100,214
MMG,400,300,0.0018796992481203006,0.01135759986937046,100,214
SoA heuristic,600,450,0.0012520868113522537,0.0003317000810056925,150,282
MMG,600,450,0.0012520868113522537,0.027689799899235368,150,282
SoA heuristic,1000,750,0.0007507507507507507,0.0004974000621587038,250,474
MMG,1000,750,0.0007507507507507507,0.07579159992747009,250,474
SoA heuristic,2000,1500,0.00037518759379689845,0.0010558001231402159,500,963
MMG,2000,1500,0.00037518759379689845,0.2886762998532504,500,963
SoA heuristic,4000,3000,0.00018754688672168043,0.002165399957448244,1000,2037
MMG,4000,3000,0.00018754688672168043,1.1929017999209464,1000,2037
SoA heuristic,8000,6000,9.376172021502688e-05,0.005091700004413724,2000,4007
MMG,8000,6000,9.376172021502688e-05,4.687508699949831,2000,4007
SoA heuristic,20,15,0.039473684210526314,2.0700041204690933e-05,5,8
MMG,20,15,0.039473684210526314,9.699980728328228e-05,5,8
SoA heuristic,40,30,0.019230769230769232,3.1299889087677e-05,10,23
MMG,40,30,0.019230769230769232,0.0002422998659312725,10,23
SoA heuristic,100,75,0.007575757575757576,7.209996692836285e-05,25,39
MMG,100,75,0.007575757575757576,0.0009251001756638288,25,39
SoA heuristic,200,150,0.0037688442211055275,0.00010339985601603985,50,91
MMG,200,150,0.0037688442211055275,0.0032741997856646776,50,91
SoA heuristic,400,300,0.0018796992481203006,0.00020270003005862236,100,202
MMG,400,300,0.0018796992481203006,0.011537499958649278,100,202
SoA heuristic,600,450,0.0012520868113522537,0.00029090000316500664,150,308
MMG,600,450,0.0012520868113522537,0.027544899843633175,150,308
SoA heuristic,1000,750,0.0007507507507507507,0.0004990999586880207,250,487
MMG,1000,750,0.0007507507507507507,0.07544340007007122,250,487
SoA heuristic,2000,1500,0.00037518759379689845,0.0011046999134123325,500,1024
MMG,2000,1500,0.00037518759379689845,0.2955368000548333,500,1024
SoA heuristic,4000,3000,0.00018754688672168043,0.002354399999603629,1000,1980
MMG,4000,3000,0.00018754688672168043,1.2162102998699993,1000,1980
SoA heuristic,8000,6000,9.376172021502688e-05,0.0050662001594901085,2000,4000
MMG,8000,6000,9.376172021502688e-05,4.8458916998934,2000,4000
SoA heuristic,20,15,0.039473684210526314,1.9200146198272705e-05,5,9
MMG,20,15,0.039473684210526314,9.010010398924351e-05,5,9
SoA heuristic,40,30,0.019230769230769232,7.790001109242439e-05,10,15
MMG,40,30,0.019230769230769232,0.0006822999566793442,10,15
SoA heuristic,100,75,0.007575757575757576,5.460018292069435e-05,25,52
MMG,100,75,0.007575757575757576,0.0009081999305635691,25,52
SoA heuristic,200,150,0.0037688442211055275,9.949994273483753e-05,50,94
MMG,200,150,0.0037688442211055275,0.0066108000464737415,50,94
SoA heuristic,400,300,0.0018796992481203006,0.00018500001169741154,100,196
MMG,400,300,0.0018796992481203006,0.011390200117602944,100,196
SoA heuristic,600,450,0.0012520868113522537,0.0008385998662561178,150,293
MMG,600,450,0.0012520868113522537,0.048439000034704804,150,293
SoA heuristic,1000,750,0.0007507507507507507,0.0005870999302715063,250,529
MMG,1000,750,0.0007507507507507507,0.07485700002871454,250,529
SoA heuristic,2000,1500,0.00037518759379689845,0.004068400012329221,500,999
MMG,2000,1500,0.00037518759379689845,0.44013109989464283,500,999
SoA heuristic,4000,3000,0.00018754688672168043,0.04079590016044676,1000,1966
MMG,4000,3000,0.00018754688672168043,1.4712123000063002,1000,1966
SoA heuristic,8000,6000,9.376172021502688e-05,0.004826599964872003,2000,3925
MMG,8000,6000,9.376172021502688e-05,5.971738199936226,2000,3925
SoA heuristic,20,15,0.039473684210526314,5.8900099247694016e-05,5,10
MMG,20,15,0.039473684210526314,0.0002885002177208662,5,10
SoA heuristic,40,30,0.019230769230769232,2.810009755194187e-05,10,17
MMG,40,30,0.019230769230769232,0.0002202000468969345,10,17
SoA heuristic,100,75,0.007575757575757576,5.2999937906861305e-05,25,54
MMG,100,75,0.007575757575757576,0.0008883001282811165,25,54
SoA heuristic,200,150,0.0037688442211055275,0.0002702998463064432,50,107
MMG,200,150,0.0037688442211055275,0.007926999824121594,50,107
SoA heuristic,400,300,0.0018796992481203006,0.0002538999542593956,100,199
MMG,400,300,0.0018796992481203006,0.01841149991378188,100,199
SoA heuristic,600,450,0.0012520868113522537,0.00029339990578591824,150,311
MMG,600,450,0.0012520868113522537,0.02718310011550784,150,311
SoA heuristic,1000,750,0.0007507507507507507,0.00044810003601014614,250,507
MMG,1000,750,0.0007507507507507507,0.08968750014901161,250,507
SoA heuristic,2000,1500,0.00037518759379689845,0.0021005000453442335,500,963
MMG,2000,1500,0.00037518759379689845,0.4016940000001341,500,963
SoA heuristic,4000,3000,0.00018754688672168043,0.0202460999134928,1000,1994
MMG,4000,3000,0.00018754688672168043,1.5952393999323249,1000,1994
SoA heuristic,8000,6000,9.376172021502688e-05,0.005130700068548322,2000,4122
MMG,8000,6000,9.376172021502688e-05,6.838001100113615,2000,4122
SoA heuristic,20,15,0.039473684210526314,1.7399899661540985e-05,5,9
MMG,20,15,0.039473684210526314,8.890009485185146e-05,5,9
SoA heuristic,40,30,0.019230769230769232,2.9299873858690262e-05,10,17
MMG,40,30,0.019230769230769232,0.00023150001652538776,10,17
SoA heuristic,100,75,0.007575757575757576,5.859998054802418e-05,25,43
MMG,100,75,0.007575757575757576,0.0010134000331163406,25,43
SoA heuristic,200,150,0.0037688442211055275,0.00010169995948672295,50,94
MMG,200,150,0.0037688442211055275,0.003168300027027726,50,94
SoA heuristic,400,300,0.0018796992481203006,0.00019819987937808037,100,174
MMG,400,300,0.0018796992481203006,0.02237400016747415,100,174
SoA heuristic,600,450,0.0012520868113522537,0.000296599930152297,150,290
MMG,600,450,0.0012520868113522537,0.026801500003784895,150,290
SoA heuristic,1000,750,0.0007507507507507507,0.0012765000574290752,250,532
MMG,1000,750,0.0007507507507507507,0.08727819984778762,250,532
SoA heuristic,2000,1500,0.00037518759379689845,0.0010367000941187143,500,1013
MMG,2000,1500,0.00037518759379689845,0.40542150009423494,500,1013
SoA heuristic,4000,3000,0.00018754688672168043,0.004629699978977442,1000,2066
MMG,4000,3000,0.00018754688672168043,2.1935231999959797,1000,2066
SoA heuristic,8000,6000,9.376172021502688e-05,0.0048166001215577126,2000,4109
MMG,8000,6000,9.376172021502688e-05,6.993313799845055,2000,4109
SoA heuristic,20,15,0.039473684210526314,2.1200161427259445e-05,5,19
MMG,20,15,0.039473684210526314,0.00010489998385310173,5,19
SoA heuristic,40,30,0.019230769230769232,3.109988756477833e-05,10,22
MMG,40,30,0.019230769230769232,0.0002725999802350998,10,22
SoA heuristic,100,75,0.007575757575757576,5.679996684193611e-05,25,58
MMG,100,75,0.007575757575757576,0.0009428998455405235,25,58
SoA heuristic,200,150,0.0037688442211055275,0.0001564000267535448,50,103
MMG,200,150,0.0037688442211055275,0.005149099975824356,50,103
SoA heuristic,400,300,0.0018796992481203006,0.0004024000372737646,100,205
MMG,400,300,0.0018796992481203006,0.02579739992506802,100,205
SoA heuristic,600,450,0.0012520868113522537,0.0009504999034106731,150,316
MMG,600,450,0.0012520868113522537,0.03495560004375875,150,316
SoA heuristic,1000,750,0.0007507507507507507,0.0007772999815642834,250,465
MMG,1000,750,0.0007507507507507507,0.0784949001390487,250,465
SoA heuristic,2000,1500,0.00037518759379689845,0.0011267999652773142,500,964
MMG,2000,1500,0.00037518759379689845,0.3285185000859201,500,964
SoA heuristic,4000,3000,0.00018754688672168043,0.006732099922373891,1000,1999
MMG,4000,3000,0.00018754688672168043,1.4774178999941796,1000,1999
SoA heuristic,8000,6000,9.376172021502688e-05,0.007349899969995022,2000,4006
MMG,8000,6000,9.376172021502688e-05,6.938849400030449,2000,4006
SoA heuristic,20,15,0.039473684210526314,2.4300068616867065e-05,5,8
MMG,20,15,0.039473684210526314,0.00011659995652735233,5,8
SoA heuristic,40,30,0.019230769230769232,2.95999925583601e-05,10,19
MMG,40,30,0.019230769230769232,0.00022680009715259075,10,19
SoA heuristic,100,75,0.007575757575757576,5.5099837481975555e-05,25,52
MMG,100,75,0.007575757575757576,0.0009542000479996204,25,52
SoA heuristic,200,150,0.0037688442211055275,0.00010179984383285046,50,96
MMG,200,150,0.0037688442211055275,0.003474300028756261,50,96
SoA heuristic,400,300,0.0018796992481203006,0.00018610013648867607,100,217
MMG,400,300,0.0018796992481203006,0.016581499949097633,100,217
SoA heuristic,600,450,0.0012520868113522537,0.000278000021353364,150,293
MMG,600,450,0.0012520868113522537,0.025143600068986416,150,293
SoA heuristic,1000,750,0.0007507507507507507,0.0009714001789689064,250,475
MMG,1000,750,0.0007507507507507507,0.08882550010457635,250,475
SoA heuristic,2000,1500,0.00037518759379689845,0.0011962999124079943,500,974
MMG,2000,1500,0.00037518759379689845,0.4069799000862986,500,974
SoA heuristic,4000,3000,0.00018754688672168043,0.002132300054654479,1000,2009
MMG,4000,3000,0.00018754688672168043,1.9225656997878104,1000,2009
SoA heuristic,8000,6000,9.376172021502688e-05,0.004421000136062503,2000,4028
MMG,8000,6000,9.376172021502688e-05,6.779776799958199,2000,4028
SoA heuristic,20,15,0.039473684210526314,2.450007013976574e-05,5,8
MMG,20,15,0.039473684210526314,0.00011859997175633907,5,8
SoA heuristic,40,30,0.019230769230769232,2.9499875381588936e-05,10,15
MMG,40,30,0.019230769230769232,0.00022449996322393417,10,15
SoA heuristic,100,75,0.007575757575757576,5.479995161294937e-05,25,57
MMG,100,75,0.007575757575757576,0.0010233998764306307,25,57
SoA heuristic,200,150,0.0037688442211055275,0.000314400065690279,50,94
MMG,200,150,0.0037688442211055275,0.007472400087863207,50,94
SoA heuristic,400,300,0.0018796992481203006,0.0005183999892324209,100,191
MMG,400,300,0.0018796992481203006,0.02705250005237758,100,191
SoA heuristic,600,450,0.0012520868113522537,0.0007805000059306622,150,296
MMG,600,450,0.0012520868113522537,0.041670500067994,150,296
SoA heuristic,1000,750,0.0007507507507507507,0.0013003998901695013,250,489
MMG,1000,750,0.0007507507507507507,0.13351850002072752,250,489
SoA heuristic,2000,1500,0.00037518759379689845,0.0014657999854534864,500,1029
MMG,2000,1500,0.00037518759379689845,0.40085599990561604,500,1029
SoA heuristic,4000,3000,0.00018754688672168043,0.0020051999017596245,1000,1968
MMG,4000,3000,0.00018754688672168043,1.6523794999811798,1000,1968
SoA heuristic,8000,6000,9.376172021502688e-05,0.011795900063589215,2000,4033
MMG,8000,6000,9.376172021502688e-05,7.004333000164479,2000,4033
SoA heuristic,20,15,0.039473684210526314,6.489991210401058e-05,5,11
MMG,20,15,0.039473684210526314,0.0002888999879360199,5,11
SoA heuristic,40,30,0.019230769230769232,9.689992293715477e-05,10,16
MMG,40,30,0.019230769230769232,0.0006446999032050371,10,16
SoA heuristic,100,75,0.007575757575757576,5.21000474691391e-05,25,56
MMG,100,75,0.007575757575757576,0.0009047999046742916,25,56
SoA heuristic,200,150,0.0037688442211055275,9.840005077421665e-05,50,98
MMG,200,150,0.0037688442211055275,0.0031916999723762274,50,98
SoA heuristic,400,300,0.0018796992481203006,0.0005830000154674053,100,219
MMG,400,300,0.0018796992481203006,0.029494300018996,100,219
SoA heuristic,600,450,0.0012520868113522537,0.0002866999711841345,150,313
MMG,600,450,0.0012520868113522537,0.028883399907499552,150,313
SoA heuristic,1000,750,0.0007507507507507507,0.0014291000552475452,250,485
MMG,1000,750,0.0007507507507507507,0.10782819986343384,250,485
SoA heuristic,2000,1500,0.00037518759379689845,0.0010138999205082655,500,996
MMG,2000,1500,0.00037518759379689845,0.4302117000333965,500,996
SoA heuristic,4000,3000,0.00018754688672168043,0.00744810001924634,1000,1964
MMG,4000,3000,0.00018754688672168043,1.8108622999861836,1000,1964
SoA heuristic,8000,6000,9.376172021502688e-05,0.005156000144779682,2000,4008
MMG,8000,6000,9.376172021502688e-05,7.325957500142977,2000,4008
SoA heuristic,20,15,0.039473684210526314,1.9900035113096237e-05,5,8
MMG,20,15,0.039473684210526314,0.00013319985009729862,5,8
SoA heuristic,40,30,0.019230769230769232,3.109988756477833e-05,10,18
MMG,40,30,0.019230769230769232,0.00022799987345933914,10,18
SoA heuristic,100,75,0.007575757575757576,5.370005965232849e-05,25,45
MMG,100,75,0.007575757575757576,0.000879799947142601,25,45
SoA heuristic,200,150,0.0037688442211055275,0.00027359998784959316,50,98
MMG,200,150,0.0037688442211055275,0.008773899869993329,50,98
SoA heuristic,400,300,0.0018796992481203006,0.0005339998751878738,100,209
MMG,400,300,0.0018796992481203006,0.02025520009920001,100,209
SoA heuristic,600,450,0.0012520868113522537,0.0008215999696403742,150,301
MMG,600,450,0.0012520868113522537,0.05320920003578067,150,301
SoA heuristic,1000,750,0.0007507507507507507,0.0005135000683367252,250,480
MMG,1000,750,0.0007507507507507507,0.1389071000739932,250,480
SoA heuristic,2000,1500,0.00037518759379689845,0.0021784999407827854,500,967
MMG,2000,1500,0.00037518759379689845,0.4321152998600155,500,967
SoA heuristic,4000,3000,0.00018754688672168043,0.02268009982071817,1000,1998
MMG,4000,3000,0.00018754688672168043,1.5722330999560654,1000,1998
SoA heuristic,8000,6000,9.376172021502688e-05,0.005439099855720997,2000,4007
MMG,8000,6000,9.376172021502688e-05,6.939099200069904,2000,4007
SoA heuristic,20,15,0.039473684210526314,2.0700041204690933e-05,5,10
MMG,20,15,0.039473684210526314,9.400001727044582e-05,5,10
SoA heuristic,40,30,0.019230769230769232,2.800021320581436e-05,10,14
MMG,40,30,0.019230769230769232,0.0005895998328924179,10,14
SoA heuristic,100,75,0.007575757575757576,0.00014410004951059818,25,58
MMG,100,75,0.007575757575757576,0.002329600043594837,25,58
SoA heuristic,200,150,0.0037688442211055275,9.900005534291267e-05,50,102
MMG,200,150,0.0037688442211055275,0.003418399952352047,50,102
SoA heuristic,400,300,0.0018796992481203006,0.0005139000713825226,100,195
MMG,400,300,0.0018796992481203006,0.020394499879330397,100,195
SoA heuristic,600,450,0.0012520868113522537,0.0007448000833392143,150,277
MMG,600,450,0.0012520868113522537,0.06401009997352958,150,277
SoA heuristic,1000,750,0.0007507507507507507,0.0007355001289397478,250,508
MMG,1000,750,0.0007507507507507507,0.09077359992079437,250,508
SoA heuristic,2000,1500,0.00037518759379689845,0.0009877998381853104,500,1032
MMG,2000,1500,0.00037518759379689845,0.41495110001415014,500,1032
SoA heuristic,4000,3000,0.00018754688672168043,0.0032347000669687986,1000,1979
MMG,4000,3000,0.00018754688672168043,1.694102399982512,1000,1979
SoA heuristic,8000,6000,9.376172021502688e-05,0.011962500168010592,2000,3999
MMG,8000,6000,9.376172021502688e-05,6.518439800012857,2000,3999
SoA heuristic,20,15,0.039473684210526314,5.950010381639004e-05,5,9
MMG,20,15,0.039473684210526314,0.00026290002278983593,5,9
SoA heuristic,40,30,0.019230769230769232,0.0001150001771748066,10,17
MMG,40,30,0.019230769230769232,0.0008668000809848309,10,17
SoA heuristic,100,75,0.007575757575757576,7.440010085701942e-05,25,50
MMG,100,75,0.007575757575757576,0.0011966999154537916,25,50
SoA heuristic,200,150,0.0037688442211055275,9.909993968904018e-05,50,103
MMG,200,150,0.0037688442211055275,0.0034204002004116774,50,103
SoA heuristic,400,300,0.0018796992481203006,0.00019039981998503208,100,192
MMG,400,300,0.0018796992481203006,0.014385799877345562,100,192
SoA heuristic,600,450,0.0012520868113522537,0.0002891002222895622,150,304
MMG,600,450,0.0012520868113522537,0.027098000049591064,150,304
SoA heuristic,1000,750,0.0007507507507507507,0.0015999998431652784,250,519
MMG,1000,750,0.0007507507507507507,0.11383879999630153,250,519
SoA heuristic,2000,1500,0.00037518759379689845,0.0010079999919980764,500,973
MMG,2000,1500,0.00037518759379689845,0.4212893999647349,500,973
SoA heuristic,4000,3000,0.00018754688672168043,0.0039323000237345695,1000,2020
MMG,4000,3000,0.00018754688672168043,1.7087630999740213,1000,2020
SoA heuristic,8000,6000,9.376172021502688e-05,0.004321600077673793,2000,4113
MMG,8000,6000,9.376172021502688e-05,6.875868600094691,2000,4113
SoA heuristic,20,15,0.039473684210526314,1.9799917936325073e-05,5,11
MMG,20,15,0.039473684210526314,8.739996701478958e-05,5,11
SoA heuristic,40,30,0.019230769230769232,4.950002767145634e-05,10,27
MMG,40,30,0.019230769230769232,0.00023500015959143639,10,27
SoA heuristic,100,75,0.007575757575757576,0.00017529982142150402,25,63
MMG,100,75,0.007575757575757576,0.0029890998266637325,25,63
SoA heuristic,200,150,0.0037688442211055275,0.0002687000669538975,50,108
MMG,200,150,0.0037688442211055275,0.006956599885597825,50,108
SoA heuristic,400,300,0.0018796992481203006,0.0005738998297601938,100,193
MMG,400,300,0.0018796992481203006,0.034671799978241324,100,193
SoA heuristic,600,450,0.0012520868113522537,0.0007888998370617628,150,323
MMG,600,450,0.0012520868113522537,0.03806980000808835,150,323
SoA heuristic,1000,750,0.0007507507507507507,0.0008282000198960304,250,471
MMG,1000,750,0.0007507507507507507,0.1214697000104934,250,471
SoA heuristic,2000,1500,0.00037518759379689845,0.0010456000454723835,500,964
MMG,2000,1500,0.00037518759379689845,0.5194403000641614,500,964
SoA heuristic,4000,3000,0.00018754688672168043,0.004538800101727247,1000,2033
MMG,4000,3000,0.00018754688672168043,1.8539207000285387,1000,2033
SoA heuristic,8000,6000,9.376172021502688e-05,0.00576790003105998,2000,4089
MMG,8000,6000,9.376172021502688e-05,6.831487199990079,2000,4089
SoA heuristic,20,15,0.039473684210526314,1.919991336762905e-05,5,12
MMG,20,15,0.039473684210526314,9.12998802959919e-05,5,12
SoA heuristic,40,30,0.019230769230769232,2.810009755194187e-05,10,20
MMG,40,30,0.019230769230769232,0.00022449996322393417,10,20
SoA heuristic,100,75,0.007575757575757576,5.6399963796138763e-05,25,41
MMG,100,75,0.007575757575757576,0.0009107000660151243,25,41
SoA heuristic,200,150,0.0037688442211055275,0.00013950001448392868,50,103
MMG,200,150,0.0037688442211055275,0.0032580001279711723,50,103
SoA heuristic,400,300,0.0018796992481203006,0.00020080013200640678,100,186
MMG,400,300,0.0018796992481203006,0.012413499876856804,100,186
SoA heuristic,600,450,0.0012520868113522537,0.0002973999362438917,150,305
MMG,600,450,0.0012520868113522537,0.028320700163021684,150,305
SoA heuristic,1000,750,0.0007507507507507507,0.0005038999952375889,250,489
MMG,1000,750,0.0007507507507507507,0.07387079996988177,250,489
SoA heuristic,2000,1500,0.00037518759379689845,0.001119599910452962,500,980
MMG,2000,1500,0.00037518759379689845,0.291860300116241,500,980
SoA heuristic,4000,3000,0.00018754688672168043,0.002181100193411112,1000,2056
MMG,4000,3000,0.00018754688672168043,1.1820591997820884,1000,2056
SoA heuristic,8000,6000,9.376172021502688e-05,0.00451119989156723,2000,4088
MMG,8000,6000,9.376172021502688e-05,4.671601000009105,2000,4088
SoA heuristic,20,15,0.039473684210526314,2.0800158381462097e-05,5,9
MMG,20,15,0.039473684210526314,9.820004925131798e-05,5,9
SoA heuristic,40,30,0.019230769230769232,3.0700117349624634e-05,10,30
MMG,40,30,0.019230769230769232,0.00034580007195472717,10,30
SoA heuristic,100,75,0.007575757575757576,5.62998466193676e-05,25,70
MMG,100,75,0.007575757575757576,0.0009310999885201454,25,70
SoA heuristic,200,150,0.0037688442211055275,0.0001083998940885067,50,100
MMG,200,150,0.0037688442211055275,0.003438299987465143,50,100
SoA heuristic,400,300,0.0018796992481203006,0.00020779995247721672,100,215
MMG,400,300,0.0018796992481203006,0.011760100023820996,100,215
SoA heuristic,600,450,0.0012520868113522537,0.0003046998754143715,150,321
MMG,600,450,0.0012520868113522537,0.027841600123792887,150,321
SoA heuristic,1000,750,0.0007507507507507507,0.0006732000038027763,250,487
MMG,1000,750,0.0007507507507507507,0.07465029996819794,250,487
SoA heuristic,2000,1500,0.00037518759379689845,0.0011090999469161034,500,1008
MMG,2000,1500,0.00037518759379689845,0.29335439996793866,500,1008
SoA heuristic,4000,3000,0.00018754688672168043,0.0026279001031070948,1000,1963
MMG,4000,3000,0.00018754688672168043,1.2254351999145001,1000,1963
SoA heuristic,8000,6000,9.376172021502688e-05,0.005375300068408251,2000,4027
MMG,8000,6000,9.376172021502688e-05,4.684497500071302,2000,4027
SoA heuristic,20,15,0.039473684210526314,1.919991336762905e-05,5,8
MMG,20,15,0.039473684210526314,9.690015576779842e-05,5,8
SoA heuristic,40,30,0.019230769230769232,2.850010059773922e-05,10,17
MMG,40,30,0.019230769230769232,0.00023039989173412323,10,17
SoA heuristic,100,75,0.007575757575757576,5.630007945001125e-05,25,58
MMG,100,75,0.007575757575757576,0.0009522999171167612,25,58
SoA heuristic,200,150,0.0037688442211055275,9.979982860386372e-05,50,88
MMG,200,150,0.0037688442211055275,0.003128000069409609,50,88
SoA heuristic,400,300,0.0018796992481203006,0.0001826002262532711,100,181
MMG,400,300,0.0018796992481203006,0.011519799940288067,100,181
SoA heuristic,600,450,0.0012520868113522537,0.00030800001695752144,150,303
MMG,600,450,0.0012520868113522537,0.027757100062444806,150,303
SoA heuristic,1000,750,0.0007507507507507507,0.0004966999404132366,250,490
MMG,1000,750,0.0007507507507507507,0.07502259989269078,250,490
SoA heuristic,2000,1500,0.00037518759379689845,0.0010162999387830496,500,979
MMG,2000,1500,0.00037518759379689845,0.2940287000965327,500,979
SoA heuristic,4000,3000,0.00018754688672168043,0.002013999968767166,1000,2021
MMG,4000,3000,0.00018754688672168043,1.1503401000518352,1000,2021
SoA heuristic,8000,6000,9.376172021502688e-05,0.004165400052443147,2000,4133
MMG,8000,6000,9.376172021502688e-05,4.609584099845961,2000,4133
SoA heuristic,20,15,0.039473684210526314,1.8700025975704193e-05,5,18
MMG,20,15,0.039473684210526314,0.00010750000365078449,5,18
SoA heuristic,40,30,0.019230769230769232,2.6999972760677338e-05,10,16
MMG,40,30,0.019230769230769232,0.00022120005451142788,10,16
SoA heuristic,100,75,0.007575757575757576,6.669992581009865e-05,25,55
MMG,100,75,0.007575757575757576,0.0009377999231219292,25,55
SoA heuristic,200,150,0.0037688442211055275,0.0001009001862257719,50,101
MMG,200,150,0.0037688442211055275,0.003249799832701683,50,101
SoA heuristic,400,300,0.0018796992481203006,0.00021309987641870975,100,226
MMG,400,300,0.0018796992481203006,0.011485999915748835,100,226
SoA heuristic,600,450,0.0012520868113522537,0.00030860002152621746,150,311
MMG,600,450,0.0012520868113522537,0.027897899970412254,150,311
SoA heuristic,1000,750,0.0007507507507507507,0.0005080001428723335,250,529
MMG,1000,750,0.0007507507507507507,0.07529919990338385,250,529
SoA heuristic,2000,1500,0.00037518759379689845,0.0011217000428587198,500,969
MMG,2000,1500,0.00037518759379689845,0.2963904000353068,500,969
SoA heuristic,4000,3000,0.00018754688672168043,0.002182499971240759,1000,1945
MMG,4000,3000,0.00018754688672168043,1.190445400075987,1000,1945
SoA heuristic,8000,6000,9.376172021502688e-05,0.004498600028455257,2000,3974
MMG,8000,6000,9.376172021502688e-05,4.8615963000338525,2000,3974
SoA heuristic,20,15,0.039473684210526314,1.900014467537403e-05,5,5
MMG,20,15,0.039473684210526314,9.290012530982494e-05,5,5
SoA heuristic,40,30,0.019230769230769232,2.8999987989664078e-05,10,14
MMG,40,30,0.019230769230769232,0.0002462000120431185,10,14
SoA heuristic,100,75,0.007575757575757576,5.8999983593821526e-05,25,48
MMG,100,75,0.007575757575757576,0.001003399956971407,25,48
SoA heuristic,200,150,0.0037688442211055275,9.940005838871002e-05,50,92
MMG,200,150,0.0037688442211055275,0.003143100067973137,50,92
SoA heuristic,400,300,0.0018796992481203006,0.00023799994960427284,100,183
MMG,400,300,0.0018796992481203006,0.012619999935850501,100,183
SoA heuristic,600,450,0.0012520868113522537,0.00030559999868273735,150,291
MMG,600,450,0.0012520868113522537,0.02743749995715916,150,291
SoA heuristic,1000,750,0.0007507507507507507,0.0005157999694347382,250,507
MMG,1000,750,0.0007507507507507507,0.07581770000979304,250,507
SoA heuristic,2000,1500,0.00037518759379689845,0.0011307999957352877,500,1005
MMG,2000,1500,0.00037518759379689845,0.29829210019670427,500,1005
SoA heuristic,4000,3000,0.00018754688672168043,0.0019481000490486622,1000,1950
MMG,4000,3000,0.00018754688672168043,1.189508100040257,1000,1950
SoA heuristic,8000,6000,9.376172021502688e-05,0.00704649998806417,2000,3984
MMG,8000,6000,9.376172021502688e-05,5.016092499950901,2000,3984
SoA heuristic,20,15,0.039473684210526314,2.2300053387880325e-05,5,8
MMG,20,15,0.039473684210526314,0.00010109995491802692,5,8
SoA heuristic,40,30,0.019230769230769232,2.9799994081258774e-05,10,18
MMG,40,30,0.019230769230769232,0.00023060012608766556,10,18
SoA heuristic,100,75,0.007575757575757576,5.969987250864506e-05,25,36
MMG,100,75,0.007575757575757576,0.0009803001303225756,25,36
SoA heuristic,200,150,0.0037688442211055275,0.00011000013910233974,50,93
MMG,200,150,0.0037688442211055275,0.003243600018322468,50,93
SoA heuristic,400,300,0.0018796992481203006,0.00020820018835365772,100,186
MMG,400,300,0.0018796992481203006,0.012650700053200126,100,186
SoA heuristic,600,450,0.0012520868113522537,0.00030640000477433205,150,266
MMG,600,450,0.0012520868113522537,0.028050800086930394,150,266
SoA heuristic,1000,750,0.0007507507507507507,0.0005332001019269228,250,508
MMG,1000,750,0.0007507507507507507,0.07626729994080961,250,508
SoA heuristic,2000,1500,0.00037518759379689845,0.001105200033634901,500,1026
MMG,2000,1500,0.00037518759379689845,0.29425349994562566,500,1026
SoA heuristic,4000,3000,0.00018754688672168043,0.002452900167554617,1000,1940
MMG,4000,3000,0.00018754688672168043,1.1957870998885483,1000,1940
SoA heuristic,8000,6000,9.376172021502688e-05,0.005527000175788999,2000,4008
MMG,8000,6000,9.376172021502688e-05,4.848451900063083,2000,4008
SoA heuristic,20,15,0.039473684210526314,3.800005652010441e-05,5,13
MMG,20,15,0.039473684210526314,0.00012769992463290691,5,13
SoA heuristic,40,30,0.019230769230769232,3.9700185880064964e-05,10,21
MMG,40,30,0.019230769230769232,0.00033769989386200905,10,21
SoA heuristic,100,75,0.007575757575757576,5.650008097290993e-05,25,58
MMG,100,75,0.007575757575757576,0.0009985000360757113,25,58
SoA heuristic,200,150,0.0037688442211055275,0.00011950009502470493,50,97
MMG,200,150,0.0037688442211055275,0.003571300068870187,50,97
SoA heuristic,400,300,0.0018796992481203006,0.00022600009106099606,100,227
MMG,400,300,0.0018796992481203006,0.017366699874401093,100,227
SoA heuristic,600,450,0.0012520868113522537,0.0003383001312613487,150,271
MMG,600,450,0.0012520868113522537,0.029755700146779418,150,271
SoA heuristic,1000,750,0.0007507507507507507,0.0005262000486254692,250,472
MMG,1000,750,0.0007507507507507507,0.07617629994638264,250,472
SoA heuristic,2000,1500,0.00037518759379689845,0.0011368999257683754,500,1047
MMG,2000,1500,0.00037518759379689845,0.2837153999134898,500,1047
SoA heuristic,4000,3000,0.00018754688672168043,0.002084400039166212,1000,1972
MMG,4000,3000,0.00018754688672168043,1.2149173999205232,1000,1972
SoA heuristic,8000,6000,9.376172021502688e-05,0.0046525998041033745,2000,4005
MMG,8000,6000,9.376172021502688e-05,4.892550300108269,2000,4005
SoA heuristic,20,15,0.039473684210526314,1.9600149244070053e-05,5,9
MMG,20,15,0.039473684210526314,9.389990009367466e-05,5,9
SoA heuristic,40,30,0.019230769230769232,2.8499867767095566e-05,10,23
MMG,40,30,0.019230769230769232,0.00023010000586509705,10,23
SoA heuristic,100,75,0.007575757575757576,5.719996988773346e-05,25,40
MMG,100,75,0.007575757575757576,0.0009781999979168177,25,40
SoA heuristic,200,150,0.0037688442211055275,0.00010990002192556858,50,110
MMG,200,150,0.0037688442211055275,0.0034501999616622925,50,110
SoA heuristic,400,300,0.0018796992481203006,0.00021330011077225208,100,195
MMG,400,300,0.0018796992481203006,0.012747199973091483,100,195
SoA heuristic,600,450,0.0012520868113522537,0.0003043999895453453,150,275
MMG,600,450,0.0012520868113522537,0.028031199937686324,150,275
SoA heuristic,1000,750,0.0007507507507507507,0.0005135000683367252,250,488
MMG,1000,750,0.0007507507507507507,0.07575369998812675,250,488
SoA heuristic,2000,1500,0.00037518759379689845,0.014111199881881475,500,1001
MMG,2000,1500,0.00037518759379689845,0.2817116000223905,500,1001
SoA heuristic,4000,3000,0.00018754688672168043,0.0022422000765800476,1000,1980
MMG,4000,3000,0.00018754688672168043,1.1451351998839527,1000,1980
SoA heuristic,8000,6000,9.376172021502688e-05,0.005303400103002787,2000,4033
MMG,8000,6000,9.376172021502688e-05,4.86794689996168,2000,4033
