name,nodes,edges,density,time,result_set,result_w
SoA heuristic,20,15,0.039473684210526314,2.010003663599491e-05,5,13
MMG,20,15,0.039473684210526314,9.310012683272362e-05,5,13
SoA heuristic,40,30,0.019230769230769232,2.9799994081258774e-05,10,19
MMG,40,30,0.019230769230769232,0.00024030008353292942,10,19
SoA heuristic,100,75,0.007575757575757576,6.029987707734108e-05,25,48
MMG,100,75,0.007575757575757576,0.0009492000099271536,25,48
SoA heuristic,200,150,0.0037688442211055275,0.00011070002801716328,50,118
MMG,200,150,0.0037688442211055275,0.0034094001166522503,50,118
SoA heuristic,400,300,0.0018796992481203006,0.00020160013809800148,100,201
MMG,400,300,0.0018796992481203006,0.01246170001104474,100,201
SoA heuristic,600,450,0.0012520868113522537,0.00029479991644620895,150,276
MMG,600,450,0.0012520868113522537,0.028644099831581116,150,276
SoA heuristic,1000,750,0.0007507507507507507,0.0004926999099552631,250,540
MMG,1000,750,0.0007507507507507507,0.07415749994106591,250,540
SoA heuristic,2000,1500,0.00037518759379689845,0.0010683999862521887,500,1022
MMG,2000,1500,0.00037518759379689845,0.2839411001186818,500,1022
SoA heuristic,4000,3000,0.00018754688672168043,0.03192560002207756,1000,1960
MMG,4000,3000,0.00018754688672168043,1.1971193000208586,1000,1960
SoA heuristic,8000,6000,9.376172021502688e-05,0.033873300068080425,2000,3918
MMG,8000,6000,9.376172021502688e-05,4.838295300025493,2000,3918
SoA heuristic,20,15,0.039473684210526314,2.059992402791977e-05,5,11
MMG,20,15,0.039473684210526314,9.75998118519783e-05,5,11
SoA heuristic,40,30,0.019230769230769232,3.0800001695752144e-05,10,19
MMG,40,30,0.019230769230769232,0.00023790006525814533,10,19
SoA heuristic,100,75,0.007575757575757576,6.230012513697147e-05,25,46
MMG,100,75,0.007575757575757576,0.0009371000342071056,25,46
SoA heuristic,200,150,0.0037688442211055275,0.00010720011778175831,50,110
MMG,200,150,0.0037688442211055275,0.0034425000194460154,50,110
SoA heuristic,400,300,0.0018796992481203006,0.0002210000529885292,100,221
MMG,400,300,0.0018796992481203006,0.012739400146529078,100,221
SoA heuristic,600,450,0.0012520868113522537,0.0003241999074816704,150,305
MMG,600,450,0.0012520868113522537,0.027922699926421046,150,305
SoA heuristic,1000,750,0.0007507507507507507,0.0005129000637680292,250,510
MMG,1000,750,0.0007507507507507507,0.07476560003124177,250,510
SoA heuristic,2000,1500,0.00037518759379689845,0.0012351998593658209,500,1040
MMG,2000,1500,0.00037518759379689845,0.2922598000150174,500,1040
SoA heuristic,4000,3000,0.00018754688672168043,0.002769300015643239,1000,1992
MMG,4000,3000,0.00018754688672168043,1.1411778000183403,1000,1992
SoA heuristic,8000,6000,9.376172021502688e-05,0.0050230000633746386,2000,3988
MMG,8000,6000,9.376172021502688e-05,4.775435900082812,2000,3988
SoA heuristic,20,15,0.039473684210526314,1.910002902150154e-05,5,10
MMG,20,15,0.039473684210526314,9.369989857077599e-05,5,10
SoA heuristic,40,30,0.019230769230769232,3.400002606213093e-05,10,22
MMG,40,30,0.019230769230769232,0.00024710013531148434,10,22
SoA heuristic,100,75,0.007575757575757576,5.540018901228905e-05,25,54
MMG,100,75,0.007575757575757576,0.0009178000036627054,25,54
SoA heuristic,200,150,0.0037688442211055275,0.00010529998689889908,50,101
MMG,200,150,0.0037688442211055275,0.0033285999670624733,50,101
SoA heuristic,400,300,0.0018796992481203006,0.00020810007117688656,100,208
MMG,400,300,0.0018796992481203006,0.012635700171813369,100,208
SoA heuristic,600,450,0.0012520868113522537,0.0003106999211013317,150,319
MMG,600,450,0.0012520868113522537,0.027274300111457705,150,319
SoA heuristic,1000,750,0.0007507507507507507,0.0004980999510735273,250,438
MMG,1000,750,0.0007507507507507507,0.07385519985109568,250,438
SoA heuristic,2000,1500,0.00037518759379689845,0.0010777998249977827,500,1027
MMG,2000,1500,0.00037518759379689845,0.29272729996591806,500,1027
SoA heuristic,4000,3000,0.00018754688672168043,0.019224500050768256,1000,1999
MMG,4000,3000,0.00018754688672168043,1.1941762000788003,1000,1999
SoA heuristic,8000,6000,9.376172021502688e-05,0.006214699940755963,2000,4021
MMG,8000,6000,9.376172021502688e-05,6.533953499980271,2000,4021
SoA heuristic,20,15,0.039473684210526314,2.210005186498165e-05,5,13
MMG,20,15,0.039473684210526314,0.00010720011778175831,5,13
SoA heuristic,40,30,0.019230769230769232,2.9299873858690262e-05,10,16
MMG,40,30,0.019230769230769232,0.00022739986889064312,10,16
SoA heuristic,100,75,0.007575757575757576,0.00011990009807050228,25,39
MMG,100,75,0.007575757575757576,0.002160100033506751,25,39
SoA heuristic,200,150,0.0037688442211055275,9.749992750585079e-05,50,98
MMG,200,150,0.0037688442211055275,0.005894799949601293,50,98
SoA heuristic,400,300,0.0018796992481203006,0.000179600203409791,100,221
MMG,400,300,0.0018796992481203006,0.01680300012230873,100,221
SoA heuristic,600,450,0.0012520868113522537,0.0008006000425666571,150,292
MMG,600,450,0.0012520868113522537,0.06889820005744696,150,292
SoA heuristic,1000,750,0.0007507507507507507,0.0014504999853670597,250,490
MMG,1000,750,0.0007507507507507507,0.14034199994057417,250,490
SoA heuristic,2000,1500,0.00037518759379689845,0.0021100000012665987,500,976
MMG,2000,1500,0.00037518759379689845,0.4667763998731971,500,976
SoA heuristic,4000,3000,0.00018754688672168043,0.0024296999908983707,1000,2025
MMG,4000,3000,0.00018754688672168043,2.0489036000799388,1000,2025
SoA heuristic,8000,6000,9.376172021502688e-05,0.01493750000372529,2000,4026
MMG,8000,6000,9.376172021502688e-05,8.009696200024337,2000,4026
SoA heuristic,20,15,0.039473684210526314,2.019992098212242e-05,5,9
MMG,20,15,0.039473684210526314,9.540002793073654e-05,5,9
SoA heuristic,40,30,0.019230769230769232,3.96000687032938e-05,10,22
MMG,40,30,0.019230769230769232,0.00031889998354017735,10,22
SoA heuristic,100,75,0.007575757575757576,0.00015199999324977398,25,43
MMG,100,75,0.007575757575757576,0.002574299927800894,25,43
SoA heuristic,200,150,0.0037688442211055275,9.50000248849392e-05,50,95
MMG,200,150,0.0037688442211055275,0.0030405998695641756,50,95
SoA heuristic,400,300,0.0018796992481203006,0.00018030009232461452,100,211
MMG,400,300,0.0018796992481203006,0.012021900154650211,100,211
SoA heuristic,600,450,0.0012520868113522537,0.0008640999440103769,150,296
MMG,600,450,0.0012520868113522537,0.05920190014876425,150,296
SoA heuristic,1000,750,0.0007507507507507507,0.0011935001239180565,250,467
MMG,1000,750,0.0007507507507507507,0.109526899876073,250,467
SoA heuristic,2000,1500,0.00037518759379689845,0.001636300003156066,500,986
MMG,2000,1500,0.00037518759379689845,0.4113209000788629,500,986
SoA heuristic,4000,3000,0.00018754688672168043,0.03164809988811612,1000,1986
MMG,4000,3000,0.00018754688672168043,1.6548627000302076,1000,1986
SoA heuristic,8000,6000,9.376172021502688e-05,0.013174900086596608,2000,3982
MMG,8000,6000,9.376172021502688e-05,7.890499500092119,2000,3982
SoA heuristic,20,15,0.039473684210526314,1.910002902150154e-05,5,10
MMG,20,15,0.039473684210526314,8.979998528957367e-05,5,10
SoA heuristic,40,30,0.019230769230769232,2.869986928999424e-05,10,20
MMG,40,30,0.019230769230769232,0.00022419984452426434,10,20
SoA heuristic,100,75,0.007575757575757576,0.00016050017438828945,25,50
MMG,100,75,0.007575757575757576,0.0026633997913450003,25,50
SoA heuristic,200,150,0.0037688442211055275,0.0004383998457342386,50,91
MMG,200,150,0.0037688442211055275,0.009610099950805306,50,91
SoA heuristic,400,300,0.0018796992481203006,0.0005266000516712666,100,196
MMG,400,300,0.0018796992481203006,0.01979679986834526,100,196
SoA heuristic,600,450,0.0012520868113522537,0.00028200005181133747,150,277
MMG,600,450,0.0012520868113522537,0.035135499900206923,150,277
SoA heuristic,1000,750,0.0007507507507507507,0.0011964000295847654,250,508
MMG,1000,750,0.0007507507507507507,0.1650402001105249,250,508
SoA heuristic,2000,1500,0.00037518759379689845,0.001158999977633357,500,975
MMG,2000,1500,0.00037518759379689845,0.45094799995422363,500,975
SoA heuristic,4000,3000,0.00018754688672168043,0.004429400200024247,1000,2078
MMG,4000,3000,0.00018754688672168043,2.0026012000162154,1000,2078
SoA heuristic,8000,6000,9.376172021502688e-05,0.00894780014641583,2000,3923
MMG,8000,6000,9.376172021502688e-05,7.893770499853417,2000,3923
SoA heuristic,20,15,0.039473684210526314,2.5799963623285294e-05,5,5
MMG,20,15,0.039473684210526314,0.00012780004180967808,5,5
SoA heuristic,40,30,0.019230769230769232,2.7999980375170708e-05,10,20
MMG,40,30,0.019230769230769232,0.0002196000423282385,10,20
SoA heuristic,100,75,0.007575757575757576,9.569991379976273e-05,25,40
MMG,100,75,0.007575757575757576,0.0013751001097261906,25,40
SoA heuristic,200,150,0.0037688442211055275,0.0002921000123023987,50,93
MMG,200,150,0.0037688442211055275,0.007970700040459633,50,93
SoA heuristic,400,300,0.0018796992481203006,0.0002006001304835081,100,186
MMG,400,300,0.0018796992481203006,0.011268400121480227,100,186
SoA heuristic,600,450,0.0012520868113522537,0.0002666001673787832,150,279
MMG,600,450,0.0012520868113522537,0.0509470000397414,150,279
SoA heuristic,1000,750,0.0007507507507507507,0.0012932000681757927,250,495
MMG,1000,750,0.0007507507507507507,0.1286955000832677,250,495
SoA heuristic,2000,1500,0.00037518759379689845,0.0015815000515431166,500,995
MMG,2000,1500,0.00037518759379689845,0.4539990001358092,500,995
SoA heuristic,4000,3000,0.00018754688672168043,0.005610699998214841,1000,1866
MMG,4000,3000,0.00018754688672168043,2.013653399888426,1000,1866
SoA heuristic,8000,6000,9.376172021502688e-05,0.006799000082537532,2000,3995
MMG,8000,6000,9.376172021502688e-05,7.201544200070202,2000,3995
SoA heuristic,20,15,0.039473684210526314,1.8700025975704193e-05,5,12
MMG,20,15,0.039473684210526314,0.00010329997166991234,5,12
SoA heuristic,40,30,0.019230769230769232,8.369982242584229e-05,10,20
MMG,40,30,0.019230769230769232,0.0006936001591384411,10,20
SoA heuristic,100,75,0.007575757575757576,0.00014479993842542171,25,40
MMG,100,75,0.007575757575757576,0.0024323000106960535,25,40
SoA heuristic,200,150,0.0037688442211055275,0.00011339993216097355,50,93
MMG,200,150,0.0037688442211055275,0.0032687000930309296,50,93
SoA heuristic,400,300,0.0018796992481203006,0.00018710014410316944,100,186
MMG,400,300,0.0018796992481203006,0.017824700102210045,100,186
SoA heuristic,600,450,0.0012520868113522537,0.0009449999779462814,150,298
MMG,600,450,0.0012520868113522537,0.06033680005930364,150,298
SoA heuristic,1000,750,0.0007507507507507507,0.00044320011511445045,250,541
MMG,1000,750,0.0007507507507507507,0.09717740002088249,250,541
SoA heuristic,2000,1500,0.00037518759379689845,0.001198100158944726,500,1017
MMG,2000,1500,0.00037518759379689845,0.5069486999418586,500,1017
SoA heuristic,4000,3000,0.00018754688672168043,0.003235100070014596,1000,1945
MMG,4000,3000,0.00018754688672168043,1.7831184999085963,1000,1945
SoA heuristic,8000,6000,9.376172021502688e-05,0.008882800117135048,2000,4116
MMG,8000,6000,9.376172021502688e-05,7.874558300012723,2000,4116
SoA heuristic,20,15,0.039473684210526314,3.269989974796772e-05,5,10
MMG,20,15,0.039473684210526314,0.0001898000482469797,5,10
SoA heuristic,40,30,0.019230769230769232,4.42001037299633e-05,10,16
MMG,40,30,0.019230769230769232,0.0002862000837922096,10,16
SoA heuristic,100,75,0.007575757575757576,5.469983443617821e-05,25,50
MMG,100,75,0.007575757575757576,0.0009182000067085028,25,50
SoA heuristic,200,150,0.0037688442211055275,0.0002872999757528305,50,92
MMG,200,150,0.0037688442211055275,0.005752000026404858,50,92
SoA heuristic,400,300,0.0018796992481203006,0.0005636999849230051,100,185
MMG,400,300,0.0018796992481203006,0.01807969994843006,100,185
SoA heuristic,600,450,0.0012520868113522537,0.0002652001567184925,150,289
MMG,600,450,0.0012520868113522537,0.025477400049567223,150,289
SoA heuristic,1000,750,0.0007507507507507507,0.000488300109282136,250,462
MMG,1000,750,0.0007507507507507507,0.08265180001035333,250,462
SoA heuristic,2000,1500,0.00037518759379689845,0.001516199903562665,500,1042
MMG,2000,1500,0.00037518759379689845,0.48367780004628,500,1042
SoA heuristic,4000,3000,0.00018754688672168043,0.020312299951910973,1000,2019
MMG,4000,3000,0.00018754688672168043,1.7635794000234455,1000,2019
SoA heuristic,8000,6000,9.376172021502688e-05,0.05811399989761412,2000,4169
MMG,8000,6000,9.376172021502688e-05,7.807891300180927,2000,4169
SoA heuristic,20,15,0.039473684210526314,5.859998054802418e-05,5,9
MMG,20,15,0.039473684210526314,0.00031509995460510254,5,9
SoA heuristic,40,30,0.019230769230769232,4.520011134445667e-05,10,25
MMG,40,30,0.019230769230769232,0.00026800017803907394,10,25
SoA heuristic,100,75,0.007575757575757576,5.5900076404213905e-05,25,51
MMG,100,75,0.007575757575757576,0.0009151999838650227,25,51
SoA heuristic,200,150,0.0037688442211055275,0.0003659999929368496,50,83
MMG,200,150,0.0037688442211055275,0.0130559999961406,50,83
SoA heuristic,400,300,0.0018796992481203006,0.0001821001060307026,100,174
MMG,400,300,0.0018796992481203006,0.014308700105175376,100,174
SoA heuristic,600,450,0.0012520868113522537,0.0002882999833673239,150,258
MMG,600,450,0.0012520868113522537,0.028739199973642826,150,258
SoA heuristic,1000,750,0.0007507507507507507,0.0013218000531196594,250,483
MMG,1000,750,0.0007507507507507507,0.12141330004669726,250,483
SoA heuristic,2000,1500,0.00037518759379689845,0.0015281999949365854,500,1023
MMG,2000,1500,0.00037518759379689845,0.48156649991869926,500,1023
SoA heuristic,4000,3000,0.00018754688672168043,0.045095899840816855,1000,1945
MMG,4000,3000,0.00018754688672168043,1.8828498998191208,1000,1945
SoA heuristic,8000,6000,9.376172021502688e-05,0.05831829993985593,2000,3904
MMG,8000,6000,9.376172021502688e-05,7.925212000031024,2000,3904
SoA heuristic,20,15,0.039473684210526314,5.439994856715202e-05,5,14
MMG,20,15,0.039473684210526314,0.0002710998523980379,5,14
SoA heuristic,40,30,0.019230769230769232,3.6400044336915016e-05,10,16
MMG,40,30,0.019230769230769232,0.00030259997583925724,10,16
SoA heuristic,100,75,0.007575757575757576,5.600019358098507e-05,25,47
MMG,100,75,0.007575757575757576,0.0009188000112771988,25,47
SoA heuristic,200,150,0.0037688442211055275,9.789993055164814e-05,50,105
MMG,200,150,0.0037688442211055275,0.007274300092831254,50,105
SoA heuristic,400,300,0.0018796992481203006,0.0005395999178290367,100,210
MMG,400,300,0.0018796992481203006,0.020518400007858872,100,210
SoA heuristic,600,450,0.0012520868113522537,0.0002661999315023422,150,319
MMG,600,450,0.0012520868113522537,0.028680399991571903,150,319
SoA heuristic,1000,750,0.0007507507507507507,0.0005032001063227654,250,520
MMG,1000,750,0.0007507507507507507,0.16037100018002093,250,520
SoA heuristic,2000,1500,0.00037518759379689845,0.0029682000167667866,500,1040
MMG,2000,1500,0.00037518759379689845,0.5011964999139309,500,1040
SoA heuristic,4000,3000,0.00018754688672168043,0.002022000029683113,1000,2124
MMG,4000,3000,0.00018754688672168043,1.7694969999138266,1000,2124
SoA heuristic,8000,6000,9.376172021502688e-05,0.0058991999831050634,2000,3981
MMG,8000,6000,9.376172021502688e-05,7.6565521999727935,2000,3981
SoA heuristic,20,15,0.039473684210526314,2.2999942302703857e-05,5,13
MMG,20,15,0.039473684210526314,0.00011090002954006195,5,13
SoA heuristic,40,30,0.019230769230769232,2.6499852538108826e-05,10,31
MMG,40,30,0.019230769230769232,0.00021869991905987263,10,31
SoA heuristic,100,75,0.007575757575757576,5.410006269812584e-05,25,39
MMG,100,75,0.007575757575757576,0.0009278999641537666,25,39
SoA heuristic,200,150,0.0037688442211055275,0.00017650006338953972,50,111
MMG,200,150,0.0037688442211055275,0.0039057000540196896,50,111
SoA heuristic,400,300,0.0018796992481203006,0.0003714000340551138,100,215
MMG,400,300,0.0018796992481203006,0.03253530012443662,100,215
SoA heuristic,600,450,0.0012520868113522537,0.0007786999922245741,150,296
MMG,600,450,0.0012520868113522537,0.0480895999353379,150,296
SoA heuristic,1000,750,0.0007507507507507507,0.0011662999168038368,250,504
MMG,1000,750,0.0007507507507507507,0.12498979992233217,250,504
SoA heuristic,2000,1500,0.00037518759379689845,0.017065400024876,500,994
MMG,2000,1500,0.00037518759379689845,0.4378611999563873,500,994
SoA heuristic,4000,3000,0.00018754688672168043,0.04851380013860762,1000,1991
MMG,4000,3000,0.00018754688672168043,1.8662779999431223,1000,1991
SoA heuristic,8000,6000,9.376172021502688e-05,0.00856459978967905,2000,3896
MMG,8000,6000,9.376172021502688e-05,7.881189200095832,2000,3896
SoA heuristic,20,15,0.039473684210526314,5.270005203783512e-05,5,8
MMG,20,15,0.039473684210526314,0.0002758000046014786,5,8
SoA heuristic,40,30,0.019230769230769232,3.6499928683042526e-05,10,17
MMG,40,30,0.019230769230769232,0.00030429987236857414,10,17
SoA heuristic,100,75,0.007575757575757576,5.440018139779568e-05,25,53
MMG,100,75,0.007575757575757576,0.0009247998241335154,25,53
SoA heuristic,200,150,0.0037688442211055275,0.00029690004885196686,50,97
MMG,200,150,0.0037688442211055275,0.009300899924710393,50,97
SoA heuristic,400,300,0.0018796992481203006,0.0004610000178217888,100,205
MMG,400,300,0.0018796992481203006,0.02520759985782206,100,205
SoA heuristic,600,450,0.0012520868113522537,0.0002695999573916197,150,255
MMG,600,450,0.0012520868113522537,0.04063030006363988,150,255
SoA heuristic,1000,750,0.0007507507507507507,0.0009367000311613083,250,484
MMG,1000,750,0.0007507507507507507,0.0859342000912875,250,484
SoA heuristic,2000,1500,0.00037518759379689845,0.016338800080120564,500,1008
MMG,2000,1500,0.00037518759379689845,0.40928809996694326,500,1008
SoA heuristic,4000,3000,0.00018754688672168043,0.019765099976211786,1000,1988
MMG,4000,3000,0.00018754688672168043,1.7755781000014395,1000,1988
SoA heuristic,8000,6000,9.376172021502688e-05,0.004894499899819493,2000,4005
MMG,8000,6000,9.376172021502688e-05,7.642363900085911,2000,4005
SoA heuristic,20,15,0.039473684210526314,3.1700124964118004e-05,5,8
MMG,20,15,0.039473684210526314,0.00015350012108683586,5,8
SoA heuristic,40,30,0.019230769230769232,3.720005042850971e-05,10,15
MMG,40,30,0.019230769230769232,0.00027900002896785736,10,15
SoA heuristic,100,75,0.007575757575757576,5.45999500900507e-05,25,43
MMG,100,75,0.007575757575757576,0.0009047000203281641,25,43
SoA heuristic,200,150,0.0037688442211055275,9.949994273483753e-05,50,95
MMG,200,150,0.0037688442211055275,0.003167900023981929,50,95
SoA heuristic,400,300,0.0018796992481203006,0.0006275000050663948,100,219
MMG,400,300,0.0018796992481203006,0.024424700066447258,100,219
SoA heuristic,600,450,0.0012520868113522537,0.0008961998391896486,150,304
MMG,600,450,0.0012520868113522537,0.06403500004671514,150,304
SoA heuristic,1000,750,0.0007507507507507507,0.0009501997847110033,250,497
MMG,1000,750,0.0007507507507507507,0.1535964000504464,250,497
SoA heuristic,2000,1500,0.00037518759379689845,0.0010188000742346048,500,960
MMG,2000,1500,0.00037518759379689845,0.5105610999744385,500,960
SoA heuristic,4000,3000,0.00018754688672168043,0.002025800058618188,1000,2029
MMG,4000,3000,0.00018754688672168043,2.098671500105411,1000,2029
SoA heuristic,8000,6000,9.376172021502688e-05,0.01434200000949204,2000,4064
MMG,8000,6000,9.376172021502688e-05,7.630992299877107,2000,4064
SoA heuristic,20,15,0.039473684210526314,3.269989974796772e-05,5,12
MMG,20,15,0.039473684210526314,0.00016709999181330204,5,12
SoA heuristic,40,30,0.019230769230769232,2.5900080800056458e-05,10,16
MMG,40,30,0.019230769230769232,0.00021620001643896103,10,16
SoA heuristic,100,75,0.007575757575757576,5.91999851167202e-05,25,41
MMG,100,75,0.007575757575757576,0.0008928000461310148,25,41
SoA heuristic,200,150,0.0037688442211055275,0.00010419986210763454,50,98
MMG,200,150,0.0037688442211055275,0.0033327999990433455,50,98
SoA heuristic,400,300,0.0018796992481203006,0.00018360000103712082,100,201
MMG,400,300,0.0018796992481203006,0.022441300097852945,100,201
SoA heuristic,600,450,0.0012520868113522537,0.00026519992388784885,150,281
MMG,600,450,0.0012520868113522537,0.02975899982266128,150,281
SoA heuristic,1000,750,0.0007507507507507507,0.0014480999670922756,250,528
MMG,1000,750,0.0007507507507507507,0.11974849994294345,250,528
SoA heuristic,2000,1500,0.00037518759379689845,0.0030846998561173677,500,1027
MMG,2000,1500,0.00037518759379689845,0.4474442999344319,500,1027
SoA heuristic,4000,3000,0.00018754688672168043,0.002002699999138713,1000,1932
MMG,4000,3000,0.00018754688672168043,1.9314264999702573,1000,1932
SoA heuristic,8000,6000,9.376172021502688e-05,0.005065200151875615,2000,4001
MMG,8000,6000,9.376172021502688e-05,7.322347400011495,2000,4001
SoA heuristic,20,15,0.039473684210526314,5.640019662678242e-05,5,9
MMG,20,15,0.039473684210526314,0.0002949000336229801,5,9
SoA heuristic,40,30,0.019230769230769232,2.750009298324585e-05,10,15
MMG,40,30,0.019230769230769232,0.0005459000822156668,10,15
SoA heuristic,100,75,0.007575757575757576,0.00015820004045963287,25,57
MMG,100,75,0.007575757575757576,0.0028001999016851187,25,57
SoA heuristic,200,150,0.0037688442211055275,9.520002640783787e-05,50,97
MMG,200,150,0.0037688442211055275,0.005664899945259094,50,97
SoA heuristic,400,300,0.0018796992481203006,0.0005731000564992428,100,202
MMG,400,300,0.0018796992481203006,0.029031400103121996,100,202
SoA heuristic,600,450,0.0012520868113522537,0.0008702999912202358,150,294
MMG,600,450,0.0012520868113522537,0.053455600049346685,150,294
SoA heuristic,1000,750,0.0007507507507507507,0.0013821001630276442,250,524
MMG,1000,750,0.0007507507507507507,0.13349479995667934,250,524
SoA heuristic,2000,1500,0.00037518759379689845,0.003137999912723899,500,960
MMG,2000,1500,0.00037518759379689845,0.5002226999495178,500,960
SoA heuristic,4000,3000,0.00018754688672168043,0.004126000218093395,1000,2035
MMG,4000,3000,0.00018754688672168043,1.7732983999885619,1000,2035
SoA heuristic,8000,6000,9.376172021502688e-05,0.0048033001367002726,2000,3972
MMG,8000,6000,9.376172021502688e-05,7.750829700147733,2000,3972
SoA heuristic,20,15,0.039473684210526314,3.820005804300308e-05,5,9
MMG,20,15,0.039473684210526314,0.00020750006660819054,5,9
SoA heuristic,40,30,0.019230769230769232,8.690007962286472e-05,10,13
MMG,40,30,0.019230769230769232,0.0006536000873893499,10,13
SoA heuristic,100,75,0.007575757575757576,5.21000474691391e-05,25,47
MMG,100,75,0.007575757575757576,0.001021800097078085,25,47
SoA heuristic,200,150,0.0037688442211055275,0.00015540001913905144,50,103
MMG,200,150,0.0037688442211055275,0.007428300101310015,50,103
SoA heuristic,400,300,0.0018796992481203006,0.0005404998082667589,100,183
MMG,400,300,0.0018796992481203006,0.020977000007405877,100,183
SoA heuristic,600,450,0.0012520868113522537,0.0008376000914722681,150,300
MMG,600,450,0.0012520868113522537,0.07140849996358156,150,300
SoA heuristic,1000,750,0.0007507507507507507,0.00211610016413033,250,435
MMG,1000,750,0.0007507507507507507,0.16487809992395341,250,435
SoA heuristic,2000,1500,0.00037518759379689845,0.001757199876010418,500,1039
MMG,2000,1500,0.00037518759379689845,0.4856674000620842,500,1039
SoA heuristic,4000,3000,0.00018754688672168043,0.005527300061658025,1000,1985
MMG,4000,3000,0.00018754688672168043,1.8995110001415014,1000,1985
SoA heuristic,8000,6000,9.376172021502688e-05,0.004893100121989846,2000,3904
MMG,8000,6000,9.376172021502688e-05,7.640274900011718,2000,3904
SoA heuristic,20,15,0.039473684210526314,1.8799910321831703e-05,5,18
MMG,20,15,0.039473684210526314,9.069987572729588e-05,5,18
SoA heuristic,40,30,0.019230769230769232,2.859998494386673e-05,10,21
MMG,40,30,0.019230769230769232,0.00022570020519196987,10,21
SoA heuristic,100,75,0.007575757575757576,0.0001588000450283289,25,61
MMG,100,75,0.007575757575757576,0.001980900065973401,25,61
SoA heuristic,200,150,0.0037688442211055275,0.0001697000116109848,50,100
MMG,200,150,0.0037688442211055275,0.0044732000678777695,50,100
SoA heuristic,400,300,0.0018796992481203006,0.0002396001946181059,100,186
MMG,400,300,0.0018796992481203006,0.027259700000286102,100,186
SoA heuristic,600,450,0.0012520868113522537,0.00046200002543628216,150,322
MMG,600,450,0.0012520868113522537,0.025386600056663156,150,322
SoA heuristic,1000,750,0.0007507507507507507,0.001205200096592307,250,492
MMG,1000,750,0.0007507507507507507,0.10465829982422292,250,492
SoA heuristic,2000,1500,0.00037518759379689845,0.0010053999722003937,500,981
MMG,2000,1500,0.00037518759379689845,0.4486507000401616,500,981
SoA heuristic,4000,3000,0.00018754688672168043,0.002113400027155876,1000,1899
MMG,4000,3000,0.00018754688672168043,1.8717503000516444,1000,1899
SoA heuristic,8000,6000,9.376172021502688e-05,0.009838500060141087,2000,3996
MMG,8000,6000,9.376172021502688e-05,7.454565500142053,2000,3996
SoA heuristic,20,15,0.039473684210526314,1.8900027498602867e-05,5,11
MMG,20,15,0.039473684210526314,9.189988486468792e-05,5,11
SoA heuristic,40,30,0.019230769230769232,3.050011582672596e-05,10,23
MMG,40,30,0.019230769230769232,0.00022389995865523815,10,23
SoA heuristic,100,75,0.007575757575757576,5.310005508363247e-05,25,34
MMG,100,75,0.007575757575757576,0.0009332001209259033,25,34
SoA heuristic,200,150,0.0037688442211055275,0.0002881998661905527,50,114
MMG,200,150,0.0037688442211055275,0.008009999990463257,50,114
SoA heuristic,400,300,0.0018796992481203006,0.0001835001166909933,100,187
MMG,400,300,0.0018796992481203006,0.032673600129783154,100,187
SoA heuristic,600,450,0.0012520868113522537,0.0002747999969869852,150,307
MMG,600,450,0.0012520868113522537,0.056767899775877595,150,307
SoA heuristic,1000,750,0.0007507507507507507,0.00044490001164376736,250,490
MMG,1000,750,0.0007507507507507507,0.11827670014463365,250,490
SoA heuristic,2000,1500,0.00037518759379689845,0.0014122000429779291,500,1022
MMG,2000,1500,0.00037518759379689845,0.4381428000051528,500,1022
SoA heuristic,4000,3000,0.00018754688672168043,0.021494700107723475,1000,1976
MMG,4000,3000,0.00018754688672168043,1.9869979999493808,1000,1976
SoA heuristic,8000,6000,9.376172021502688e-05,0.007985600037500262,2000,3951
MMG,8000,6000,9.376172021502688e-05,7.383503500139341,2000,3951
SoA heuristic,20,15,0.039473684210526314,6.87998253852129e-05,5,9
MMG,20,15,0.039473684210526314,0.00028920010663568974,5,9
SoA heuristic,40,30,0.019230769230769232,7.699988782405853e-05,10,23
MMG,40,30,0.019230769230769232,0.0006494000554084778,10,23
SoA heuristic,100,75,0.007575757575757576,5.4900068789720535e-05,25,47
MMG,100,75,0.007575757575757576,0.0009433000814169645,25,47
SoA heuristic,200,150,0.0037688442211055275,9.530014358460903e-05,50,89
MMG,200,150,0.0037688442211055275,0.003025999991223216,50,89
SoA heuristic,400,300,0.0018796992481203006,0.0002250999677926302,100,213
MMG,400,300,0.0018796992481203006,0.011732899816706777,100,213
SoA heuristic,600,450,0.0012520868113522537,0.0008374000899493694,150,285
MMG,600,450,0.0012520868113522537,0.06208529998548329,150,285
SoA heuristic,1000,750,0.0007507507507507507,0.0010446000378578901,250,507
MMG,1000,750,0.0007507507507507507,0.15275250002741814,250,507
SoA heuristic,2000,1500,0.00037518759379689845,0.0010114999022334814,500,934
MMG,2000,1500,0.00037518759379689845,0.4362778998911381,500,934
SoA heuristic,4000,3000,0.00018754688672168043,0.002024400047957897,1000,1959
MMG,4000,3000,0.00018754688672168043,1.6283699001651257,1000,1959
SoA heuristic,8000,6000,9.376172021502688e-05,0.005326600046828389,2000,3960
MMG,8000,6000,9.376172021502688e-05,7.785614000167698,2000,3960
SoA heuristic,20,15,0.039473684210526314,1.9600149244070053e-05,5,12
MMG,20,15,0.039473684210526314,9.350012987852097e-05,5,12
SoA heuristic,40,30,0.019230769230769232,2.859998494386673e-05,10,18
MMG,40,30,0.019230769230769232,0.00022579985670745373,10,18
SoA heuristic,100,75,0.007575757575757576,5.619996227324009e-05,25,35
MMG,100,75,0.007575757575757576,0.0008966999594122171,25,35
SoA heuristic,200,150,0.0037688442211055275,9.570014663040638e-05,50,108
MMG,200,150,0.0037688442211055275,0.0030235000886023045,50,108
SoA heuristic,400,300,0.0018796992481203006,0.00018289987929165363,100,183
MMG,400,300,0.0018796992481203006,0.020091800019145012,100,183
SoA heuristic,600,450,0.0012520868113522537,0.0002770000137388706,150,258
MMG,600,450,0.0012520868113522537,0.03748350008390844,150,258
SoA heuristic,1000,750,0.0007507507507507507,0.0011992000509053469,250,499
MMG,1000,750,0.0007507507507507507,0.13934919983148575,250,499
SoA heuristic,2000,1500,0.00037518759379689845,0.001012700144201517,500,1057
MMG,2000,1500,0.00037518759379689845,0.4045162999536842,500,1057
SoA heuristic,4000,3000,0.00018754688672168043,0.005296699935570359,1000,2053
MMG,4000,3000,0.00018754688672168043,1.9630986999254674,1000,2053
SoA heuristic,8000,6000,9.376172021502688e-05,0.013940100092440844,2000,3994
MMG,8000,6000,9.376172021502688e-05,7.6306779000442475,2000,3994
SoA heuristic,20,15,0.039473684210526314,1.859990879893303e-05,5,5
MMG,20,15,0.039473684210526314,8.899997919797897e-05,5,5
SoA heuristic,40,30,0.019230769230769232,3.529991954565048e-05,10,19
MMG,40,30,0.019230769230769232,0.00023150001652538776,10,19
SoA heuristic,100,75,0.007575757575757576,0.00016200006939470768,25,51
MMG,100,75,0.007575757575757576,0.0027759000658988953,25,51
SoA heuristic,200,150,0.0037688442211055275,0.0002992998342961073,50,84
MMG,200,150,0.0037688442211055275,0.007774900179356337,50,84
SoA heuristic,400,300,0.0018796992481203006,0.0002967000473290682,100,203
MMG,400,300,0.0018796992481203006,0.012956300051882863,100,203
SoA heuristic,600,450,0.0012520868113522537,0.0008272998966276646,150,308
MMG,600,450,0.0012520868113522537,0.05221199989318848,150,308
SoA heuristic,1000,750,0.0007507507507507507,0.00044510001316666603,250,491
MMG,1000,750,0.0007507507507507507,0.08914569998160005,250,491
SoA heuristic,2000,1500,0.00037518759379689845,0.0010949999559670687,500,1006
MMG,2000,1500,0.00037518759379689845,0.4827221999876201,500,1006
SoA heuristic,4000,3000,0.00018754688672168043,0.007361800177022815,1000,1970
MMG,4000,3000,0.00018754688672168043,2.0632788001094013,1000,1970
SoA heuristic,8000,6000,9.376172021502688e-05,0.008547399891540408,2000,3971
MMG,8000,6000,9.376172021502688e-05,7.381905399961397,2000,3971
SoA heuristic,20,15,0.039473684210526314,6.209989078342915e-05,5,9
MMG,20,15,0.039473684210526314,0.00028229993768036366,5,9
SoA heuristic,40,30,0.019230769230769232,8.530006743967533e-05,10,13
MMG,40,30,0.019230769230769232,0.0006548999808728695,10,13
SoA heuristic,100,75,0.007575757575757576,0.000157299917191267,25,47
MMG,100,75,0.007575757575757576,0.0029704999178647995,25,47
SoA heuristic,200,150,0.0037688442211055275,0.0002851998433470726,50,86
MMG,200,150,0.0037688442211055275,0.007618600036948919,50,86
SoA heuristic,400,300,0.0018796992481203006,0.0005226000212132931,100,191
MMG,400,300,0.0018796992481203006,0.028697700006887317,100,191
SoA heuristic,600,450,0.0012520868113522537,0.000843999907374382,150,329
MMG,600,450,0.0012520868113522537,0.06802599993534386,150,329
SoA heuristic,1000,750,0.0007507507507507507,0.0004694999661296606,250,472
MMG,1000,750,0.0007507507507507507,0.18631729995831847,250,472
SoA heuristic,2000,1500,0.00037518759379689845,0.002052599797025323,500,1010
MMG,2000,1500,0.00037518759379689845,0.43704760004766285,500,1010
SoA heuristic,4000,3000,0.00018754688672168043,0.002934700110927224,1000,2007
MMG,4000,3000,0.00018754688672168043,1.937485700007528,1000,2007
SoA heuristic,8000,6000,9.376172021502688e-05,0.013204000191763043,2000,3866
MMG,8000,6000,9.376172021502688e-05,7.528464399976656,2000,3866
SoA heuristic,20,15,0.039473684210526314,1.969980075955391e-05,5,9
MMG,20,15,0.039473684210526314,9.769992902874947e-05,5,9
SoA heuristic,40,30,0.019230769230769232,2.66998540610075e-05,10,12
MMG,40,30,0.019230769230769232,0.00021869991905987263,10,12
SoA heuristic,100,75,0.007575757575757576,5.369982682168484e-05,25,55
MMG,100,75,0.007575757575757576,0.0008869001176208258,25,55
SoA heuristic,200,150,0.0037688442211055275,9.649991989135742e-05,50,94
MMG,200,150,0.0037688442211055275,0.0030185000505298376,50,94
SoA heuristic,400,300,0.0018796992481203006,0.00018010009080171585,100,182
MMG,400,300,0.0018796992481203006,0.024092799983918667,100,182
SoA heuristic,600,450,0.0012520868113522537,0.0002708001993596554,150,294
MMG,600,450,0.0012520868113522537,0.02481990004889667,150,294
SoA heuristic,1000,750,0.0007507507507507507,0.000718599883839488,250,489
MMG,1000,750,0.0007507507507507507,0.13710819999687374,250,489
SoA heuristic,2000,1500,0.00037518759379689845,0.0028911998961120844,500,977
MMG,2000,1500,0.00037518759379689845,0.559925900073722,500,977
SoA heuristic,4000,3000,0.00018754688672168043,0.0026633001398295164,1000,2065
MMG,4000,3000,0.00018754688672168043,1.7751360000111163,1000,2065
SoA heuristic,8000,6000,9.376172021502688e-05,0.008266699966043234,2000,3933
MMG,8000,6000,9.376172021502688e-05,7.802151900017634,2000,3933
SoA heuristic,20,15,0.039473684210526314,1.8700025975704193e-05,5,13
MMG,20,15,0.039473684210526314,9.50999092310667e-05,5,13
SoA heuristic,40,30,0.019230769230769232,2.9499875381588936e-05,10,21
MMG,40,30,0.019230769230769232,0.00023930007591843605,10,21
SoA heuristic,100,75,0.007575757575757576,0.00015649991109967232,25,47
MMG,100,75,0.007575757575757576,0.0012125000357627869,25,47
SoA heuristic,200,150,0.0037688442211055275,9.489990770816803e-05,50,98
MMG,200,150,0.0037688442211055275,0.0031642999965697527,50,98
SoA heuristic,400,300,0.0018796992481203006,0.00017850007861852646,100,198
MMG,400,300,0.0018796992481203006,0.01092659984715283,100,198
SoA heuristic,600,450,0.0012520868113522537,0.0002785001415759325,150,315
MMG,600,450,0.0012520868113522537,0.028686299920082092,150,315
SoA heuristic,1000,750,0.0007507507507507507,0.0010710000060498714,250,480
MMG,1000,750,0.0007507507507507507,0.10288630006834865,250,480
SoA heuristic,2000,1500,0.00037518759379689845,0.0011863000690937042,500,971
MMG,2000,1500,0.00037518759379689845,0.5059594998601824,500,971
SoA heuristic,4000,3000,0.00018754688672168043,0.008510499959811568,1000,2006
MMG,4000,3000,0.00018754688672168043,2.041523499879986,1000,2006
SoA heuristic,8000,6000,9.376172021502688e-05,0.06573190004564822,2000,4090
MMG,8000,6000,9.376172021502688e-05,7.539817399811,2000,4090
SoA heuristic,20,15,0.039473684210526314,1.9799917936325073e-05,5,10
MMG,20,15,0.039473684210526314,9.240000508725643e-05,5,10
SoA heuristic,40,30,0.019230769230769232,2.719997428357601e-05,10,20
MMG,40,30,0.019230769230769232,0.00021949992515146732,10,20
SoA heuristic,100,75,0.007575757575757576,0.00014939997345209122,25,48
MMG,100,75,0.007575757575757576,0.002454100176692009,25,48
SoA heuristic,200,150,0.0037688442211055275,0.00039650010876357555,50,98
MMG,200,150,0.0037688442211055275,0.005355000030249357,50,98
SoA heuristic,400,300,0.0018796992481203006,0.00046989996917545795,100,210
MMG,400,300,0.0018796992481203006,0.0181791998911649,100,210
SoA heuristic,600,450,0.0012520868113522537,0.000849299831315875,150,276
MMG,600,450,0.0012520868113522537,0.05859420006163418,150,276
SoA heuristic,1000,750,0.0007507507507507507,0.0014295000582933426,250,453
MMG,1000,750,0.0007507507507507507,0.15027690003626049,250,453
SoA heuristic,2000,1500,0.00037518759379689845,0.001007499871775508,500,1026
MMG,2000,1500,0.00037518759379689845,0.46028759982436895,500,1026
SoA heuristic,4000,3000,0.00018754688672168043,0.0058750000316649675,1000,1951
MMG,4000,3000,0.00018754688672168043,2.0665239000227302,1000,1951
SoA heuristic,8000,6000,9.376172021502688e-05,0.04624109994620085,2000,3943
MMG,8000,6000,9.376172021502688e-05,7.428872999968007,2000,3943
SoA heuristic,20,15,0.039473684210526314,1.9900035113096237e-05,5,17
MMG,20,15,0.039473684210526314,9.220000356435776e-05,5,17
SoA heuristic,40,30,0.019230769230769232,2.759997732937336e-05,10,16
MMG,40,30,0.019230769230769232,0.00021920003928244114,10,16
SoA heuristic,100,75,0.007575757575757576,5.259993486106396e-05,25,76
MMG,100,75,0.007575757575757576,0.0010571000166237354,25,76
SoA heuristic,200,150,0.0037688442211055275,0.00010069995187222958,50,87
MMG,200,150,0.0037688442211055275,0.0030477000400424004,50,87
SoA heuristic,400,300,0.0018796992481203006,0.00018470012582838535,100,197
MMG,400,300,0.0018796992481203006,0.016162999905645847,100,197
SoA heuristic,600,450,0.0012520868113522537,0.0003521998878568411,150,287
MMG,600,450,0.0012520868113522537,0.051790199941024184,150,287
SoA heuristic,1000,750,0.0007507507507507507,0.0004811999388039112,250,482
MMG,1000,750,0.0007507507507507507,0.08952259994111955,250,482
SoA heuristic,2000,1500,0.00037518759379689845,0.0010841998737305403,500,1017
MMG,2000,1500,0.00037518759379689845,0.5442596999928355,500,1017
SoA heuristic,4000,3000,0.00018754688672168043,0.004925600020214915,1000,2041
MMG,4000,3000,0.00018754688672168043,1.8002716999035329,1000,2041
SoA heuristic,8000,6000,9.376172021502688e-05,0.016339899972081184,2000,3943
MMG,8000,6000,9.376172021502688e-05,7.545985500095412,2000,3943
SoA heuristic,20,15,0.039473684210526314,1.9800150766968727e-05,5,7
MMG,20,15,0.039473684210526314,9.079999290406704e-05,5,7
SoA heuristic,40,30,0.019230769230769232,2.659996971487999e-05,10,21
MMG,40,30,0.019230769230769232,0.00021609989926218987,10,21
SoA heuristic,100,75,0.007575757575757576,5.320017226040363e-05,25,50
MMG,100,75,0.007575757575757576,0.0009336001239717007,25,50
SoA heuristic,200,150,0.0037688442211055275,0.0001237001270055771,50,107
MMG,200,150,0.0037688442211055275,0.003214099910110235,50,107
SoA heuristic,400,300,0.0018796992481203006,0.00018360000103712082,100,207
MMG,400,300,0.0018796992481203006,0.03122800006531179,100,207
SoA heuristic,600,450,0.0012520868113522537,0.0002663999330252409,150,296
MMG,600,450,0.0012520868113522537,0.03560439986176789,150,296
SoA heuristic,1000,750,0.0007507507507507507,0.0012733000330626965,250,487
MMG,1000,750,0.0007507507507507507,0.1581941000185907,250,487
SoA heuristic,2000,1500,0.00037518759379689845,0.002973299939185381,500,1008
MMG,2000,1500,0.00037518759379689845,0.4533784999512136,500,1008
SoA heuristic,4000,3000,0.00018754688672168043,0.007205900037661195,1000,1971
MMG,4000,3000,0.00018754688672168043,1.8323160000145435,1000,1971
SoA heuristic,8000,6000,9.376172021502688e-05,0.004391300026327372,2000,3966
MMG,8000,6000,9.376172021502688e-05,7.320574999786913,2000,3966
SoA heuristic,20,15,0.039473684210526314,2.3999949917197227e-05,5,10
MMG,20,15,0.039473684210526314,0.0001175999641418457,5,10
SoA heuristic,40,30,0.019230769230769232,2.9199989512562752e-05,10,17
MMG,40,30,0.019230769230769232,0.00022280006669461727,10,17
SoA heuristic,100,75,0.007575757575757576,0.00017020013183355331,25,52
MMG,100,75,0.007575757575757576,0.0028276999946683645,25,52
SoA heuristic,200,150,0.0037688442211055275,9.590014815330505e-05,50,90
MMG,200,150,0.0037688442211055275,0.0029794001020491123,50,90
SoA heuristic,400,300,0.0018796992481203006,0.0005698001477867365,100,199
MMG,400,300,0.0018796992481203006,0.012217800132930279,100,199
SoA heuristic,600,450,0.0012520868113522537,0.0008501000702381134,150,273
MMG,600,450,0.0012520868113522537,0.0656107000540942,150,273
SoA heuristic,1000,750,0.0007507507507507507,0.0012727000284940004,250,507
MMG,1000,750,0.0007507507507507507,0.10751240001991391,250,507
SoA heuristic,2000,1500,0.00037518759379689845,0.0012809999752789736,500,985
MMG,2000,1500,0.00037518759379689845,0.49018650013022125,500,985
SoA heuristic,4000,3000,0.00018754688672168043,0.03487089998088777,1000,1999
MMG,4000,3000,0.00018754688672168043,1.850185199873522,1000,1999
SoA heuristic,8000,6000,9.376172021502688e-05,0.04140269989147782,2000,3905
MMG,8000,6000,9.376172021502688e-05,7.58346310001798,2000,3905
