name,nodes,edges,density,time,result_set,result_w
SoA heuristic,4000,3000,0.00018754688672168043,0.006720499834045768,1000,998140
MMG,4000,3000,0.00018754688672168043,1.8742946998681873,1000,998140
SoA heuristic,4020,3015,0.00018661358546902214,0.0022499000187963247,1005,1009459
MMG,4020,3015,0.00018661358546902214,2.0165268999990076,1005,1009459
SoA heuristic,4040,3030,0.00018568952711067095,0.004074099939316511,1010,1020597
MMG,4040,3030,0.00018568952711067095,1.9761912000831217,1010,1020597
SoA heuristic,4080,3060,0.00018386859524393233,0.0024170000106096268,1020,1040204
MMG,4080,3060,0.00018386859524393233,2.15815949998796,1020,1040204
SoA heuristic,4120,3090,0.0001820830298616169,0.00679180002771318,1030,1060532
MMG,4120,3090,0.0001820830298616169,1.9906783001497388,1030,1060532
SoA heuristic,4200,3150,0.00017861395570373899,0.0022555000614374876,1050,1102585
MMG,4200,3150,0.00017861395570373899,2.069188900059089,1050,1102585
SoA heuristic,4240,3180,0.00017692852087756547,0.003131899982690811,1060,1121650
MMG,4240,3180,0.00017692852087756547,2.098499499959871,1060,1121650
SoA heuristic,4400,3300,0.00017049329393043874,0.002636399818584323,1100,1211126
MMG,4400,3300,0.00017049329393043874,2.0466114999726415,1100,1211126
SoA heuristic,4600,3450,0.00016307893020221786,0.002912800060585141,1150,1322159
MMG,4600,3450,0.00016307893020221786,2.2254810999147594,1150,1322159
SoA heuristic,4000,3000,0.00018754688672168043,0.00978569989092648,1000,1000919
MMG,4000,3000,0.00018754688672168043,1.9600740000605583,1000,1000919
SoA heuristic,4020,3015,0.00018661358546902214,0.007246499881148338,1005,1010141
MMG,4020,3015,0.00018661358546902214,1.9723023001570255,1005,1010141
SoA heuristic,4040,3030,0.00018568952711067095,0.004476500209420919,1010,1020635
MMG,4040,3030,0.00018568952711067095,1.9382702000439167,1010,1020635
SoA heuristic,4080,3060,0.00018386859524393233,0.002203600015491247,1020,1039556
MMG,4080,3060,0.00018386859524393233,2.018141800072044,1020,1039556
SoA heuristic,4120,3090,0.0001820830298616169,0.003386600175872445,1030,1062197
MMG,4120,3090,0.0001820830298616169,2.046492400113493,1030,1062197
SoA heuristic,4200,3150,0.00017861395570373899,0.0027002000715583563,1050,1101861
MMG,4200,3150,0.00017861395570373899,2.118143199943006,1050,1101861
SoA heuristic,4240,3180,0.00017692852087756547,0.0024218999315053225,1060,1123931
MMG,4240,3180,0.00017692852087756547,2.212117499904707,1060,1123931
SoA heuristic,4400,3300,0.00017049329393043874,0.002299599815160036,1100,1210720
MMG,4400,3300,0.00017049329393043874,2.260655499994755,1100,1210720
SoA heuristic,4600,3450,0.00016307893020221786,0.0024360998068004847,1150,1322705
MMG,4600,3450,0.00016307893020221786,2.06216590013355,1150,1322705
SoA heuristic,4000,3000,0.00018754688672168043,0.00692080007866025,1000,1001233
MMG,4000,3000,0.00018754688672168043,1.7644234001636505,1000,1001233
SoA heuristic,4020,3015,0.00018661358546902214,0.0072299998719245195,1005,1009770
MMG,4020,3015,0.00018661358546902214,1.7826568998862058,1005,1009770
SoA heuristic,4040,3030,0.00018568952711067095,0.005694400053471327,1010,1019991
MMG,4040,3030,0.00018568952711067095,2.1852106999140233,1010,1019991
SoA heuristic,4080,3060,0.00018386859524393233,0.0027997998986393213,1020,1039894
MMG,4080,3060,0.00018386859524393233,1.747179300058633,1020,1039894
SoA heuristic,4120,3090,0.0001820830298616169,0.0023737000301480293,1030,1061500
MMG,4120,3090,0.0001820830298616169,1.7534403000026941,1030,1061500
SoA heuristic,4200,3150,0.00017861395570373899,0.004308900097385049,1050,1102697
MMG,4200,3150,0.00017861395570373899,1.8290856999810785,1050,1102697
SoA heuristic,4240,3180,0.00017692852087756547,0.002363499952480197,1060,1123969
MMG,4240,3180,0.00017692852087756547,2.01295889983885,1060,1123969
SoA heuristic,4400,3300,0.00017049329393043874,0.002383999992161989,1100,1210832
MMG,4400,3300,0.00017049329393043874,1.9351847001817077,1100,1210832
SoA heuristic,4600,3450,0.00016307893020221786,0.0027364001143723726,1150,1322176
MMG,4600,3450,0.00016307893020221786,2.2108336000237614,1150,1322176
SoA heuristic,4000,3000,0.00018754688672168043,0.004238100023940206,1000,999278
MMG,4000,3000,0.00018754688672168043,1.9897702001035213,1000,999278
SoA heuristic,4020,3015,0.00018661358546902214,0.004143900005146861,1005,1008636
MMG,4020,3015,0.00018661358546902214,1.848031299887225,1005,1008636
SoA heuristic,4040,3030,0.00018568952711067095,0.0059553999453783035,1010,1019175
MMG,4040,3030,0.00018568952711067095,1.939235799945891,1010,1019175
SoA heuristic,4080,3060,0.00018386859524393233,0.0040554997976869345,1020,1041179
MMG,4080,3060,0.00018386859524393233,1.978871600003913,1020,1041179
SoA heuristic,4120,3090,0.0001820830298616169,0.005078099900856614,1030,1059957
MMG,4120,3090,0.0001820830298616169,2.1028887999709696,1030,1059957
SoA heuristic,4200,3150,0.00017861395570373899,0.002600400010123849,1050,1101953
MMG,4200,3150,0.00017861395570373899,2.1210815000813454,1050,1101953
SoA heuristic,4240,3180,0.00017692852087756547,0.003920300165191293,1060,1123878
MMG,4240,3180,0.00017692852087756547,2.125949600012973,1060,1123878
SoA heuristic,4400,3300,0.00017049329393043874,0.005023899953812361,1100,1208764
MMG,4400,3300,0.00017049329393043874,2.309859700035304,1100,1208764
SoA heuristic,4600,3450,0.00016307893020221786,0.005379500100389123,1150,1320718
MMG,4600,3450,0.00016307893020221786,2.4561449999455363,1150,1320718
SoA heuristic,4000,3000,0.00018754688672168043,0.0026392999570816755,1000,1000868
MMG,4000,3000,0.00018754688672168043,1.427077000029385,1000,1000868
SoA heuristic,4020,3015,0.00018661358546902214,0.003880700096487999,1005,1009341
MMG,4020,3015,0.00018661358546902214,1.4452997001353651,1005,1009341
SoA heuristic,4040,3030,0.00018568952711067095,0.002880699932575226,1010,1019511
MMG,4040,3030,0.00018568952711067095,1.4417958999983966,1010,1019511
SoA heuristic,4080,3060,0.00018386859524393233,0.0033776999916881323,1020,1041233
MMG,4080,3060,0.00018386859524393233,1.5064676001202315,1020,1041233
SoA heuristic,4120,3090,0.0001820830298616169,0.0028147001285105944,1030,1061304
MMG,4120,3090,0.0001820830298616169,1.4874870998319238,1030,1061304
SoA heuristic,4200,3150,0.00017861395570373899,0.00493939989246428,1050,1102714
MMG,4200,3150,0.00017861395570373899,1.5888669998385012,1050,1102714
SoA heuristic,4240,3180,0.00017692852087756547,0.0027576000429689884,1060,1124706
MMG,4240,3180,0.00017692852087756547,1.5616434998810291,1060,1124706
SoA heuristic,4400,3300,0.00017049329393043874,0.0028529998380690813,1100,1212050
MMG,4400,3300,0.00017049329393043874,1.7304036999121308,1100,1212050
SoA heuristic,4600,3450,0.00016307893020221786,0.003099899971857667,1150,1322163
MMG,4600,3450,0.00016307893020221786,1.83850930002518,1150,1322163
SoA heuristic,4000,3000,0.00018754688672168043,0.002641799859702587,1000,1001256
MMG,4000,3000,0.00018754688672168043,1.3686961000785232,1000,1001256
SoA heuristic,4020,3015,0.00018661358546902214,0.0026732999831438065,1005,1009290
MMG,4020,3015,0.00018661358546902214,1.401445799972862,1005,1009290
SoA heuristic,4040,3030,0.00018568952711067095,0.003069499973207712,1010,1018731
MMG,4040,3030,0.00018568952711067095,1.436402700142935,1010,1018731
SoA heuristic,4080,3060,0.00018386859524393233,0.003339999821037054,1020,1041204
MMG,4080,3060,0.00018386859524393233,1.4660571001004428,1020,1041204
SoA heuristic,4120,3090,0.0001820830298616169,0.003175499849021435,1030,1063151
MMG,4120,3090,0.0001820830298616169,1.4774317000992596,1030,1063151
SoA heuristic,4200,3150,0.00017861395570373899,0.0029636998660862446,1050,1103050
MMG,4200,3150,0.00017861395570373899,1.5130257999990135,1050,1103050
SoA heuristic,4240,3180,0.00017692852087756547,0.004762599943205714,1060,1124772
MMG,4240,3180,0.00017692852087756547,1.5579470999073237,1060,1124772
SoA heuristic,4400,3300,0.00017049329393043874,0.002903799992054701,1100,1210170
MMG,4400,3300,0.00017049329393043874,1.7023579999804497,1100,1210170
SoA heuristic,4600,3450,0.00016307893020221786,0.003086599987000227,1150,1323816
MMG,4600,3450,0.00016307893020221786,1.8429505999665707,1150,1323816
SoA heuristic,4000,3000,0.00018754688672168043,0.0060384999960660934,1000,1001544
MMG,4000,3000,0.00018754688672168043,1.4614634001627564,1000,1001544
SoA heuristic,4020,3015,0.00018661358546902214,0.0022305999882519245,1005,1011121
MMG,4020,3015,0.00018661358546902214,1.3097654001321644,1005,1011121
SoA heuristic,4040,3030,0.00018568952711067095,0.0028959999326616526,1010,1020126
MMG,4040,3030,0.00018568952711067095,1.170430100057274,1010,1020126
SoA heuristic,4080,3060,0.00018386859524393233,0.0022253000643104315,1020,1040396
MMG,4080,3060,0.00018386859524393233,1.2139743999578059,1020,1040396
SoA heuristic,4120,3090,0.0001820830298616169,0.002605200046673417,1030,1061831
MMG,4120,3090,0.0001820830298616169,1.1846223000902683,1030,1061831
SoA heuristic,4200,3150,0.00017861395570373899,0.002350799972191453,1050,1102200
MMG,4200,3150,0.00017861395570373899,1.290721499826759,1050,1102200
SoA heuristic,4240,3180,0.00017692852087756547,0.0025571000296622515,1060,1123441
MMG,4240,3180,0.00017692852087756547,1.3247747998684645,1060,1123441
SoA heuristic,4400,3300,0.00017049329393043874,0.002551899990066886,1100,1210953
MMG,4400,3300,0.00017049329393043874,1.423402599990368,1100,1210953
SoA heuristic,4600,3450,0.00016307893020221786,0.002814200008288026,1150,1322766
MMG,4600,3450,0.00016307893020221786,1.517277400009334,1150,1322766
SoA heuristic,4000,3000,0.00018754688672168043,0.0029872001614421606,1000,999286
MMG,4000,3000,0.00018754688672168043,1.1976390997879207,1000,999286
SoA heuristic,4020,3015,0.00018661358546902214,0.0023119000252336264,1005,1009653
MMG,4020,3015,0.00018661358546902214,1.2115018998738378,1005,1009653
SoA heuristic,4040,3030,0.00018568952711067095,0.0026686000637710094,1010,1021065
MMG,4040,3030,0.00018568952711067095,1.2134186001494527,1010,1021065
SoA heuristic,4080,3060,0.00018386859524393233,0.00220889993943274,1020,1039761
MMG,4080,3060,0.00018386859524393233,1.1519752999302,1020,1039761
SoA heuristic,4120,3090,0.0001820830298616169,0.0026720999740064144,1030,1062619
MMG,4120,3090,0.0001820830298616169,1.2730904999189079,1030,1062619
SoA heuristic,4200,3150,0.00017861395570373899,0.002606299938634038,1050,1104270
MMG,4200,3150,0.00017861395570373899,1.3312063999474049,1050,1104270
SoA heuristic,4240,3180,0.00017692852087756547,0.0024926001206040382,1060,1123146
MMG,4240,3180,0.00017692852087756547,1.355837499955669,1060,1123146
SoA heuristic,4400,3300,0.00017049329393043874,0.0029362000059336424,1100,1211064
MMG,4400,3300,0.00017049329393043874,1.4629331999458373,1100,1211064
SoA heuristic,4600,3450,0.00016307893020221786,0.00318829994648695,1150,1323835
MMG,4600,3450,0.00016307893020221786,1.576038199942559,1150,1323835
SoA heuristic,4000,3000,0.00018754688672168043,0.002826400101184845,1000,999288
MMG,4000,3000,0.00018754688672168043,1.6934954999014735,1000,999288
SoA heuristic,4020,3015,0.00018661358546902214,0.007050999905914068,1005,1009676
MMG,4020,3015,0.00018661358546902214,1.7591685999650508,1005,1009676
SoA heuristic,4040,3030,0.00018568952711067095,0.005523399915546179,1010,1019261
MMG,4040,3030,0.00018568952711067095,1.8198299000505358,1010,1019261
SoA heuristic,4080,3060,0.00018386859524393233,0.0026287001091986895,1020,1041009
MMG,4080,3060,0.00018386859524393233,1.668272899929434,1020,1041009
SoA heuristic,4120,3090,0.0001820830298616169,0.0034664999693632126,1030,1060253
MMG,4120,3090,0.0001820830298616169,1.892099600052461,1030,1060253
SoA heuristic,4200,3150,0.00017861395570373899,0.004786700010299683,1050,1100217
MMG,4200,3150,0.00017861395570373899,1.6592300001066178,1050,1100217
SoA heuristic,4240,3180,0.00017692852087756547,0.007245099870488048,1060,1122170
MMG,4240,3180,0.00017692852087756547,1.8199606998823583,1060,1122170
SoA heuristic,4400,3300,0.00017049329393043874,0.002394199836999178,1100,1210839
MMG,4400,3300,0.00017049329393043874,1.833030799869448,1100,1210839
SoA heuristic,4600,3450,0.00016307893020221786,0.009715600172057748,1150,1321790
MMG,4600,3450,0.00016307893020221786,2.3178642001003027,1150,1321790
SoA heuristic,4000,3000,0.00018754688672168043,0.0021003999281674623,1000,998251
MMG,4000,3000,0.00018754688672168043,1.5321925000753254,1000,998251
SoA heuristic,4020,3015,0.00018661358546902214,0.006672399817034602,1005,1010823
MMG,4020,3015,0.00018661358546902214,1.6464007999747992,1005,1010823
SoA heuristic,4040,3030,0.00018568952711067095,0.0021504999604076147,1010,1018826
MMG,4040,3030,0.00018568952711067095,1.6557108999695629,1010,1018826
SoA heuristic,4080,3060,0.00018386859524393233,0.0028919000178575516,1020,1041129
MMG,4080,3060,0.00018386859524393233,1.675236000213772,1020,1041129
SoA heuristic,4120,3090,0.0001820830298616169,0.003274500137194991,1030,1062432
MMG,4120,3090,0.0001820830298616169,1.5341008000541478,1030,1062432
SoA heuristic,4200,3150,0.00017861395570373899,0.0027764001861214638,1050,1103614
MMG,4200,3150,0.00017861395570373899,1.8450935001019388,1050,1103614
SoA heuristic,4240,3180,0.00017692852087756547,0.002968000015243888,1060,1124678
MMG,4240,3180,0.00017692852087756547,1.7441104999743402,1060,1124678
SoA heuristic,4400,3300,0.00017049329393043874,0.004394999938085675,1100,1209956
MMG,4400,3300,0.00017049329393043874,1.9412214001640677,1100,1209956
SoA heuristic,4600,3450,0.00016307893020221786,0.002509899903088808,1150,1321738
MMG,4600,3450,0.00016307893020221786,2.299093500012532,1150,1321738
SoA heuristic,4000,3000,0.00018754688672168043,0.0037023001350462437,1000,1000899
MMG,4000,3000,0.00018754688672168043,1.8338369000703096,1000,1000899
SoA heuristic,4020,3015,0.00018661358546902214,0.003949899924919009,1005,1008333
MMG,4020,3015,0.00018661358546902214,1.8011309001594782,1005,1008333
SoA heuristic,4040,3030,0.00018568952711067095,0.0021080998703837395,1010,1020811
MMG,4040,3030,0.00018568952711067095,1.9239525001030415,1010,1020811
SoA heuristic,4080,3060,0.00018386859524393233,0.004428900079801679,1020,1041804
MMG,4080,3060,0.00018386859524393233,1.9250614000484347,1020,1041804
SoA heuristic,4120,3090,0.0001820830298616169,0.0032409001141786575,1030,1060074
MMG,4120,3090,0.0001820830298616169,1.6691188998520374,1030,1060074
SoA heuristic,4200,3150,0.00017861395570373899,0.002772199921309948,1050,1101819
MMG,4200,3150,0.00017861395570373899,1.8920803999062628,1050,1101819
SoA heuristic,4240,3180,0.00017692852087756547,0.0027457999531179667,1060,1124107
MMG,4240,3180,0.00017692852087756547,1.5760055999271572,1060,1124107
SoA heuristic,4400,3300,0.00017049329393043874,0.0024182999040931463,1100,1209111
MMG,4400,3300,0.00017049329393043874,1.853573399828747,1100,1209111
SoA heuristic,4600,3450,0.00016307893020221786,0.004681299906224012,1150,1324097
MMG,4600,3450,0.00016307893020221786,2.3003064000513405,1150,1324097
SoA heuristic,4000,3000,0.00018754688672168043,0.0049674001056700945,1000,1000246
MMG,4000,3000,0.00018754688672168043,1.6111601998563856,1000,1000246
SoA heuristic,4020,3015,0.00018661358546902214,0.006942100124433637,1005,1009837
MMG,4020,3015,0.00018661358546902214,1.8661096999421716,1005,1009837
SoA heuristic,4040,3030,0.00018568952711067095,0.002445500111207366,1010,1018161
MMG,4040,3030,0.00018568952711067095,1.745338900014758,1010,1018161
SoA heuristic,4080,3060,0.00018386859524393233,0.04097940004430711,1020,1041902
MMG,4080,3060,0.00018386859524393233,1.6462485999800265,1020,1041902
SoA heuristic,4120,3090,0.0001820830298616169,0.003328799968585372,1030,1060072
MMG,4120,3090,0.0001820830298616169,1.882343800039962,1030,1060072
SoA heuristic,4200,3150,0.00017861395570373899,0.0022364999167621136,1050,1102499
MMG,4200,3150,0.00017861395570373899,2.0305728998500854,1050,1102499
SoA heuristic,4240,3180,0.00017692852087756547,0.06323400000110269,1060,1122203
MMG,4240,3180,0.00017692852087756547,2.0233946999069303,1060,1122203
SoA heuristic,4400,3300,0.00017049329393043874,0.0026996000669896603,1100,1210325
MMG,4400,3300,0.00017049329393043874,1.9156170999631286,1100,1210325
SoA heuristic,4600,3450,0.00016307893020221786,0.002581499982625246,1150,1322759
MMG,4600,3450,0.00016307893020221786,2.1823294998612255,1150,1322759
SoA heuristic,4000,3000,0.00018754688672168043,0.0073697001207619905,1000,999305
MMG,4000,3000,0.00018754688672168043,1.4920606000814587,1000,999305
SoA heuristic,4020,3015,0.00018661358546902214,0.007514699827879667,1005,1010947
MMG,4020,3015,0.00018661358546902214,1.6316880001686513,1005,1010947
SoA heuristic,4040,3030,0.00018568952711067095,0.0021536999847739935,1010,1018814
MMG,4040,3030,0.00018568952711067095,1.7093313001096249,1010,1018814
SoA heuristic,4080,3060,0.00018386859524393233,0.0022919001057744026,1020,1039905
MMG,4080,3060,0.00018386859524393233,1.7159032998606563,1020,1039905
SoA heuristic,4120,3090,0.0001820830298616169,0.0023726001381874084,1030,1062158
MMG,4120,3090,0.0001820830298616169,1.826498999958858,1030,1062158
SoA heuristic,4200,3150,0.00017861395570373899,0.0026539000682532787,1050,1101152
MMG,4200,3150,0.00017861395570373899,1.9281222000718117,1050,1101152
SoA heuristic,4240,3180,0.00017692852087756547,0.006817399989813566,1060,1122379
MMG,4240,3180,0.00017692852087756547,1.882378299953416,1060,1122379
SoA heuristic,4400,3300,0.00017049329393043874,0.002959099831059575,1100,1210230
MMG,4400,3300,0.00017049329393043874,2.1372231000568718,1100,1210230
SoA heuristic,4600,3450,0.00016307893020221786,0.0024371000472456217,1150,1324647
MMG,4600,3450,0.00016307893020221786,2.3227759001310915,1150,1324647
SoA heuristic,4000,3000,0.00018754688672168043,0.008227200014516711,1000,1000671
MMG,4000,3000,0.00018754688672168043,2.0923310997895896,1000,1000671
SoA heuristic,4020,3015,0.00018661358546902214,0.0021158000454306602,1005,1010790
MMG,4020,3015,0.00018661358546902214,1.9808831000700593,1005,1010790
SoA heuristic,4040,3030,0.00018568952711067095,0.0022048999089747667,1010,1019077
MMG,4040,3030,0.00018568952711067095,1.861115099862218,1010,1019077
SoA heuristic,4080,3060,0.00018386859524393233,0.00207719998434186,1020,1039180
MMG,4080,3060,0.00018386859524393233,2.0203350000083447,1020,1039180
SoA heuristic,4120,3090,0.0001820830298616169,0.0026360000483691692,1030,1060739
MMG,4120,3090,0.0001820830298616169,2.0509607999119908,1030,1060739
SoA heuristic,4200,3150,0.00017861395570373899,0.0054536999668926,1050,1103051
MMG,4200,3150,0.00017861395570373899,2.18747720005922,1050,1103051
SoA heuristic,4240,3180,0.00017692852087756547,0.0025983001105487347,1060,1121766
MMG,4240,3180,0.00017692852087756547,2.274179899832234,1060,1121766
SoA heuristic,4400,3300,0.00017049329393043874,0.002615500008687377,1100,1209395
MMG,4400,3300,0.00017049329393043874,2.258448600070551,1100,1209395
SoA heuristic,4600,3450,0.00016307893020221786,0.007468799827620387,1150,1323080
MMG,4600,3450,0.00016307893020221786,2.7423222998622805,1150,1323080
SoA heuristic,4000,3000,0.00018754688672168043,0.002201199997216463,1000,1000872
MMG,4000,3000,0.00018754688672168043,1.7137668000068516,1000,1000872
SoA heuristic,4020,3015,0.00018661358546902214,0.002420899923890829,1005,1011209
MMG,4020,3015,0.00018661358546902214,1.8318605001550168,1005,1011209
SoA heuristic,4040,3030,0.00018568952711067095,0.0023841001093387604,1010,1020640
MMG,4040,3030,0.00018568952711067095,2.0391565000172704,1010,1020640
SoA heuristic,4080,3060,0.00018386859524393233,0.0021490000654011965,1020,1039994
MMG,4080,3060,0.00018386859524393233,2.0086783000733703,1020,1039994
SoA heuristic,4120,3090,0.0001820830298616169,0.009290299843996763,1030,1061010
MMG,4120,3090,0.0001820830298616169,1.8905736000742763,1030,1061010
SoA heuristic,4200,3150,0.00017861395570373899,0.0021876997780054808,1050,1103612
MMG,4200,3150,0.00017861395570373899,2.175756299868226,1050,1103612
SoA heuristic,4240,3180,0.00017692852087756547,0.006622100016102195,1060,1123076
MMG,4240,3180,0.00017692852087756547,2.032605899963528,1060,1123076
SoA heuristic,4400,3300,0.00017049329393043874,0.03091189987026155,1100,1210227
MMG,4400,3300,0.00017049329393043874,2.4083758001215756,1100,1210227
SoA heuristic,4600,3450,0.00016307893020221786,0.006173999980092049,1150,1322955
MMG,4600,3450,0.00016307893020221786,2.6326089000795037,1150,1322955
SoA heuristic,4000,3000,0.00018754688672168043,0.0023874000180512667,1000,999679
MMG,4000,3000,0.00018754688672168043,1.623619700083509,1000,999679
SoA heuristic,4020,3015,0.00018661358546902214,0.002708599902689457,1005,1009267
MMG,4020,3015,0.00018661358546902214,1.611365299904719,1005,1009267
SoA heuristic,4040,3030,0.00018568952711067095,0.0021883000154048204,1010,1020104
MMG,4040,3030,0.00018568952711067095,1.8595457999035716,1010,1020104
SoA heuristic,4080,3060,0.00018386859524393233,0.002637699944898486,1020,1040572
MMG,4080,3060,0.00018386859524393233,1.6710555001627654,1020,1040572
SoA heuristic,4120,3090,0.0001820830298616169,0.0021733001340180635,1030,1059856
MMG,4120,3090,0.0001820830298616169,1.7838863001670688,1030,1059856
SoA heuristic,4200,3150,0.00017861395570373899,0.03978569991886616,1050,1100787
MMG,4200,3150,0.00017861395570373899,1.8971188999712467,1050,1100787
SoA heuristic,4240,3180,0.00017692852087756547,0.0034124997910112143,1060,1122480
MMG,4240,3180,0.00017692852087756547,2.0950058000162244,1060,1122480
SoA heuristic,4400,3300,0.00017049329393043874,0.0023499999660998583,1100,1209854
MMG,4400,3300,0.00017049329393043874,1.8284120000898838,1100,1209854
SoA heuristic,4600,3450,0.00016307893020221786,0.0032482000533491373,1150,1322579
MMG,4600,3450,0.00016307893020221786,2.1544448998756707,1150,1322579
SoA heuristic,4000,3000,0.00018754688672168043,0.002715799957513809,1000,1000719
MMG,4000,3000,0.00018754688672168043,1.8916597000788897,1000,1000719
SoA heuristic,4020,3015,0.00018661358546902214,0.0021462999284267426,1005,1008883
MMG,4020,3015,0.00018661358546902214,1.8325868002139032,1005,1008883
SoA heuristic,4040,3030,0.00018568952711067095,0.004669700050726533,1010,1022700
MMG,4040,3030,0.00018568952711067095,1.7501906999386847,1010,1022700
SoA heuristic,4080,3060,0.00018386859524393233,0.0022665001451969147,1020,1041965
MMG,4080,3060,0.00018386859524393233,1.6818995999637991,1020,1041965
SoA heuristic,4120,3090,0.0001820830298616169,0.002575299935415387,1030,1062227
MMG,4120,3090,0.0001820830298616169,1.8780468998011202,1030,1062227
SoA heuristic,4200,3150,0.00017861395570373899,0.00429509999230504,1050,1102683
MMG,4200,3150,0.00017861395570373899,1.9965951000340283,1050,1102683
SoA heuristic,4240,3180,0.00017692852087756547,0.002531900070607662,1060,1123095
MMG,4240,3180,0.00017692852087756547,2.2805443999823183,1060,1123095
SoA heuristic,4400,3300,0.00017049329393043874,0.002664799802005291,1100,1209654
MMG,4400,3300,0.00017049329393043874,2.190459599951282,1100,1209654
SoA heuristic,4600,3450,0.00016307893020221786,0.003407000098377466,1150,1323227
MMG,4600,3450,0.00016307893020221786,2.172578199999407,1150,1323227
SoA heuristic,4000,3000,0.00018754688672168043,0.002430099993944168,1000,998800
MMG,4000,3000,0.00018754688672168043,1.8995529999956489,1000,998800
SoA heuristic,4020,3015,0.00018661358546902214,0.002805399941280484,1005,1009779
MMG,4020,3015,0.00018661358546902214,1.7683965999167413,1005,1009779
SoA heuristic,4040,3030,0.00018568952711067095,0.004052300006151199,1010,1018968
MMG,4040,3030,0.00018568952711067095,1.5555781000293791,1010,1018968
SoA heuristic,4080,3060,0.00018386859524393233,0.002266900148242712,1020,1041372
MMG,4080,3060,0.00018386859524393233,1.6275188999716192,1020,1041372
SoA heuristic,4120,3090,0.0001820830298616169,0.007862400030717254,1030,1060594
MMG,4120,3090,0.0001820830298616169,2.041973700048402,1030,1060594
SoA heuristic,4200,3150,0.00017861395570373899,0.0028718002140522003,1050,1102281
MMG,4200,3150,0.00017861395570373899,1.8416559998877347,1050,1102281
SoA heuristic,4240,3180,0.00017692852087756547,0.0071876998990774155,1060,1125317
MMG,4240,3180,0.00017692852087756547,1.7738615002017468,1060,1125317
SoA heuristic,4400,3300,0.00017049329393043874,0.002461700001731515,1100,1210640
MMG,4400,3300,0.00017049329393043874,1.9202435000333935,1100,1210640
SoA heuristic,4600,3450,0.00016307893020221786,0.0024852000642567873,1150,1321414
MMG,4600,3450,0.00016307893020221786,2.2087552999146283,1150,1321414
SoA heuristic,4000,3000,0.00018754688672168043,0.0022891999687999487,1000,999857
MMG,4000,3000,0.00018754688672168043,1.801114099798724,1000,999857
SoA heuristic,4020,3015,0.00018661358546902214,0.00899040000513196,1005,1010117
MMG,4020,3015,0.00018661358546902214,1.8327085999771953,1005,1010117
SoA heuristic,4040,3030,0.00018568952711067095,0.002472399966791272,1010,1020386
MMG,4040,3030,0.00018568952711067095,1.6863913000561297,1010,1020386
SoA heuristic,4080,3060,0.00018386859524393233,0.002687399974092841,1020,1039876
MMG,4080,3060,0.00018386859524393233,1.7699041001033038,1020,1039876
SoA heuristic,4120,3090,0.0001820830298616169,0.004742399789392948,1030,1060554
MMG,4120,3090,0.0001820830298616169,1.8364588001277298,1030,1060554
SoA heuristic,4200,3150,0.00017861395570373899,0.0028649000450968742,1050,1103951
MMG,4200,3150,0.00017861395570373899,2.045172000071034,1050,1103951
SoA heuristic,4240,3180,0.00017692852087756547,0.0026851000729948282,1060,1124160
MMG,4240,3180,0.00017692852087756547,1.927398899802938,1060,1124160
SoA heuristic,4400,3300,0.00017049329393043874,0.0023340999614447355,1100,1210418
MMG,4400,3300,0.00017049329393043874,2.1081737000495195,1100,1210418
SoA heuristic,4600,3450,0.00016307893020221786,0.0024906001053750515,1150,1320960
MMG,4600,3450,0.00016307893020221786,2.4711815000046045,1150,1320960
SoA heuristic,4000,3000,0.00018754688672168043,0.002136200200766325,1000,999409
MMG,4000,3000,0.00018754688672168043,1.702965599950403,1000,999409
SoA heuristic,4020,3015,0.00018661358546902214,0.0025198999792337418,1005,1011649
MMG,4020,3015,0.00018661358546902214,2.0424832000862807,1005,1011649
SoA heuristic,4040,3030,0.00018568952711067095,0.0023266999050974846,1010,1019747
MMG,4040,3030,0.00018568952711067095,1.929833099944517,1010,1019747
SoA heuristic,4080,3060,0.00018386859524393233,0.004476099973544478,1020,1040909
MMG,4080,3060,0.00018386859524393233,1.7759763000067323,1020,1040909
SoA heuristic,4120,3090,0.0001820830298616169,0.0021973000839352608,1030,1061621
MMG,4120,3090,0.0001820830298616169,1.934519900009036,1030,1061621
SoA heuristic,4200,3150,0.00017861395570373899,0.002402199897915125,1050,1101975
MMG,4200,3150,0.00017861395570373899,1.746060699922964,1050,1101975
SoA heuristic,4240,3180,0.00017692852087756547,0.0025817998684942722,1060,1122788
MMG,4240,3180,0.00017692852087756547,1.9321236999239773,1060,1122788
SoA heuristic,4400,3300,0.00017049329393043874,0.0023922999389469624,1100,1206939
MMG,4400,3300,0.00017049329393043874,2.309372700052336,1100,1206939
SoA heuristic,4600,3450,0.00016307893020221786,0.01011970010586083,1150,1322484
MMG,4600,3450,0.00016307893020221786,2.2774654999375343,1150,1322484
SoA heuristic,4000,3000,0.00018754688672168043,0.01041109999641776,1000,997804
MMG,4000,3000,0.00018754688672168043,1.6827297999989241,1000,997804
SoA heuristic,4020,3015,0.00018661358546902214,0.002178400056436658,1005,1011549
MMG,4020,3015,0.00018661358546902214,1.9667392999399453,1005,1011549
SoA heuristic,4040,3030,0.00018568952711067095,0.007335900096222758,1010,1020382
MMG,4040,3030,0.00018568952711067095,2.000808199867606,1010,1020382
SoA heuristic,4080,3060,0.00018386859524393233,0.007372999796643853,1020,1040623
MMG,4080,3060,0.00018386859524393233,1.9153333001304418,1020,1040623
SoA heuristic,4120,3090,0.0001820830298616169,0.0027355002239346504,1030,1061213
MMG,4120,3090,0.0001820830298616169,1.7748252998571843,1030,1061213
SoA heuristic,4200,3150,0.00017861395570373899,0.00396190001629293,1050,1101566
MMG,4200,3150,0.00017861395570373899,1.7590332000982016,1050,1101566
SoA heuristic,4240,3180,0.00017692852087756547,0.03905779984779656,1060,1125139
MMG,4240,3180,0.00017692852087756547,1.8061431001406163,1060,1125139
SoA heuristic,4400,3300,0.00017049329393043874,0.0031975999008864164,1100,1209851
MMG,4400,3300,0.00017049329393043874,2.219447100069374,1100,1209851
SoA heuristic,4600,3450,0.00016307893020221786,0.0024308001156896353,1150,1321171
MMG,4600,3450,0.00016307893020221786,2.397094000130892,1150,1321171
SoA heuristic,4000,3000,0.00018754688672168043,0.006250500213354826,1000,1000896
MMG,4000,3000,0.00018754688672168043,1.7500298998784274,1000,1000896
SoA heuristic,4020,3015,0.00018661358546902214,0.0024458998814225197,1005,1010249
MMG,4020,3015,0.00018661358546902214,1.9686410001013428,1005,1010249
SoA heuristic,4040,3030,0.00018568952711067095,0.002283399924635887,1010,1021776
MMG,4040,3030,0.00018568952711067095,1.8300234999042004,1010,1021776
SoA heuristic,4080,3060,0.00018386859524393233,0.005665400065481663,1020,1039318
MMG,4080,3060,0.00018386859524393233,1.9425983000546694,1020,1039318
SoA heuristic,4120,3090,0.0001820830298616169,0.0021975000854581594,1030,1061962
MMG,4120,3090,0.0001820830298616169,1.88778610015288,1030,1061962
SoA heuristic,4200,3150,0.00017861395570373899,0.03404920012690127,1050,1103353
MMG,4200,3150,0.00017861395570373899,1.7658404000103474,1050,1103353
SoA heuristic,4240,3180,0.00017692852087756547,0.002196399960666895,1060,1122959
MMG,4240,3180,0.00017692852087756547,2.0135125999804586,1060,1122959
SoA heuristic,4400,3300,0.00017049329393043874,0.007154499879106879,1100,1209980
MMG,4400,3300,0.00017049329393043874,2.4207649999298155,1100,1209980
SoA heuristic,4600,3450,0.00016307893020221786,0.0025216001085937023,1150,1321435
MMG,4600,3450,0.00016307893020221786,2.2297273001167923,1150,1321435
SoA heuristic,4000,3000,0.00018754688672168043,0.003921499941498041,1000,1000520
MMG,4000,3000,0.00018754688672168043,1.8432621001265943,1000,1000520
SoA heuristic,4020,3015,0.00018661358546902214,0.006118600023910403,1005,1009745
MMG,4020,3015,0.00018661358546902214,1.9137085999827832,1005,1009745
SoA heuristic,4040,3030,0.00018568952711067095,0.0021491001825779676,1010,1021067
MMG,4040,3030,0.00018568952711067095,2.028045700164512,1010,1021067
SoA heuristic,4080,3060,0.00018386859524393233,0.006471000146120787,1020,1040428
MMG,4080,3060,0.00018386859524393233,1.902282299939543,1020,1040428
SoA heuristic,4120,3090,0.0001820830298616169,0.002542099915444851,1030,1062084
MMG,4120,3090,0.0001820830298616169,1.642833000048995,1030,1062084
SoA heuristic,4200,3150,0.00017861395570373899,0.006758400006219745,1050,1102568
MMG,4200,3150,0.00017861395570373899,1.9049014998599887,1050,1102568
SoA heuristic,4240,3180,0.00017692852087756547,0.006496999878436327,1060,1123412
MMG,4240,3180,0.00017692852087756547,2.11043530004099,1060,1123412
SoA heuristic,4400,3300,0.00017049329393043874,0.004240799928084016,1100,1210589
MMG,4400,3300,0.00017049329393043874,2.237743599805981,1100,1210589
SoA heuristic,4600,3450,0.00016307893020221786,0.00281929993070662,1150,1320755
MMG,4600,3450,0.00016307893020221786,2.442936400184408,1150,1320755
SoA heuristic,4000,3000,0.00018754688672168043,0.010096499929204583,1000,999718
MMG,4000,3000,0.00018754688672168043,1.8248795000836253,1000,999718
SoA heuristic,4020,3015,0.00018661358546902214,0.0072848000563681126,1005,1009020
MMG,4020,3015,0.00018661358546902214,1.8684048999566585,1005,1009020
SoA heuristic,4040,3030,0.00018568952711067095,0.0024649999104440212,1010,1020006
MMG,4040,3030,0.00018568952711067095,2.0903824002016336,1010,1020006
SoA heuristic,4080,3060,0.00018386859524393233,0.0021635000593960285,1020,1041385
MMG,4080,3060,0.00018386859524393233,1.9169289998244494,1020,1041385
SoA heuristic,4120,3090,0.0001820830298616169,0.002094399882480502,1030,1061481
MMG,4120,3090,0.0001820830298616169,1.8802352000493556,1030,1061481
SoA heuristic,4200,3150,0.00017861395570373899,0.005733700003474951,1050,1102202
MMG,4200,3150,0.00017861395570373899,2.096533700125292,1050,1102202
SoA heuristic,4240,3180,0.00017692852087756547,0.003912999993190169,1060,1121698
MMG,4240,3180,0.00017692852087756547,1.9091950999572873,1060,1121698
SoA heuristic,4400,3300,0.00017049329393043874,0.002404300030320883,1100,1211081
MMG,4400,3300,0.00017049329393043874,1.8347713998518884,1100,1211081
SoA heuristic,4600,3450,0.00016307893020221786,0.008832599967718124,1150,1324763
MMG,4600,3450,0.00016307893020221786,2.620387100148946,1150,1324763
SoA heuristic,4000,3000,0.00018754688672168043,0.0020984001457691193,1000,1000307
MMG,4000,3000,0.00018754688672168043,1.8252696001436561,1000,1000307
SoA heuristic,4020,3015,0.00018661358546902214,0.0025238001253455877,1005,1008876
MMG,4020,3015,0.00018661358546902214,1.7578380999621004,1005,1008876
SoA heuristic,4040,3030,0.00018568952711067095,0.0067269999999552965,1010,1020327
MMG,4040,3030,0.00018568952711067095,1.9427536998409778,1010,1020327
SoA heuristic,4080,3060,0.00018386859524393233,0.008290800033137202,1020,1040707
MMG,4080,3060,0.00018386859524393233,2.125321799889207,1020,1040707
SoA heuristic,4120,3090,0.0001820830298616169,0.0023074999917298555,1030,1061964
MMG,4120,3090,0.0001820830298616169,2.259670900180936,1030,1061964
SoA heuristic,4200,3150,0.00017861395570373899,0.0024388001766055822,1050,1099373
MMG,4200,3150,0.00017861395570373899,1.9003049999009818,1050,1099373
SoA heuristic,4240,3180,0.00017692852087756547,0.007017800118774176,1060,1122856
MMG,4240,3180,0.00017692852087756547,2.172370299929753,1060,1122856
SoA heuristic,4400,3300,0.00017049329393043874,0.0033203000202775,1100,1210821
MMG,4400,3300,0.00017049329393043874,2.2068125000223517,1100,1210821
SoA heuristic,4600,3450,0.00016307893020221786,0.005872000008821487,1150,1323300
MMG,4600,3450,0.00016307893020221786,2.5604630999732763,1150,1323300
SoA heuristic,4000,3000,0.00018754688672168043,0.0025611999444663525,1000,1003679
MMG,4000,3000,0.00018754688672168043,1.8401492999400944,1000,1003679
SoA heuristic,4020,3015,0.00018661358546902214,0.003953299950808287,1005,1008474
MMG,4020,3015,0.00018661358546902214,1.8188874998595566,1005,1008474
SoA heuristic,4040,3030,0.00018568952711067095,0.005759400082752109,1010,1020184
MMG,4040,3030,0.00018568952711067095,1.8907288999762386,1010,1020184
SoA heuristic,4080,3060,0.00018386859524393233,0.002684700069949031,1020,1041055
MMG,4080,3060,0.00018386859524393233,1.8890337999910116,1020,1041055
SoA heuristic,4120,3090,0.0001820830298616169,0.009114300133660436,1030,1062313
MMG,4120,3090,0.0001820830298616169,2.1343557999935,1030,1062313
SoA heuristic,4200,3150,0.00017861395570373899,0.006741899996995926,1050,1103318
MMG,4200,3150,0.00017861395570373899,2.3093809001147747,1050,1103318
SoA heuristic,4240,3180,0.00017692852087756547,0.009076300077140331,1060,1124118
MMG,4240,3180,0.00017692852087756547,2.2811647998169065,1060,1124118
SoA heuristic,4400,3300,0.00017049329393043874,0.002360300160944462,1100,1210988
MMG,4400,3300,0.00017049329393043874,2.3338876999914646,1100,1210988
SoA heuristic,4600,3450,0.00016307893020221786,0.003716300008818507,1150,1324365
MMG,4600,3450,0.00016307893020221786,2.5527063000481576,1150,1324365
SoA heuristic,4000,3000,0.00018754688672168043,0.0021353999618440866,1000,999870
MMG,4000,3000,0.00018754688672168043,2.0248684999532998,1000,999870
SoA heuristic,4020,3015,0.00018661358546902214,0.002676399890333414,1005,1010127
MMG,4020,3015,0.00018661358546902214,1.7846913000103086,1005,1010127
SoA heuristic,4040,3030,0.00018568952711067095,0.0021087999921292067,1010,1020945
MMG,4040,3030,0.00018568952711067095,1.8121374999172986,1010,1020945
SoA heuristic,4080,3060,0.00018386859524393233,0.0038242998998612165,1020,1040630
MMG,4080,3060,0.00018386859524393233,2.2215915000997484,1020,1040630
SoA heuristic,4120,3090,0.0001820830298616169,0.0028031000401824713,1030,1061532
MMG,4120,3090,0.0001820830298616169,2.128844399936497,1030,1061532
SoA heuristic,4200,3150,0.00017861395570373899,0.006836700020357966,1050,1105092
MMG,4200,3150,0.00017861395570373899,2.152373499935493,1050,1105092
SoA heuristic,4240,3180,0.00017692852087756547,0.007208900060504675,1060,1125193
MMG,4240,3180,0.00017692852087756547,2.164819600060582,1060,1125193
SoA heuristic,4400,3300,0.00017049329393043874,0.008152900030836463,1100,1209732
MMG,4400,3300,0.00017049329393043874,2.3493937999010086,1100,1209732
SoA heuristic,4600,3450,0.00016307893020221786,0.00815919996239245,1150,1324765
MMG,4600,3450,0.00016307893020221786,2.6703866000752896,1150,1324765
SoA heuristic,4000,3000,0.00018754688672168043,0.002184299984946847,1000,1001456
MMG,4000,3000,0.00018754688672168043,1.9616274000145495,1000,1001456
SoA heuristic,4020,3015,0.00018661358546902214,0.0024937998969107866,1005,1010131
MMG,4020,3015,0.00018661358546902214,2.152266199933365,1005,1010131
SoA heuristic,4040,3030,0.00018568952711067095,0.002512899925932288,1010,1021215
MMG,4040,3030,0.00018568952711067095,2.054277600022033,1010,1021215
SoA heuristic,4080,3060,0.00018386859524393233,0.002994599984958768,1020,1041009
MMG,4080,3060,0.00018386859524393233,1.6603325000032783,1020,1041009
SoA heuristic,4120,3090,0.0001820830298616169,0.0022897999733686447,1030,1060913
MMG,4120,3090,0.0001820830298616169,2.0087114998605102,1030,1060913
SoA heuristic,4200,3150,0.00017861395570373899,0.0572048001922667,1050,1101977
MMG,4200,3150,0.00017861395570373899,2.1499755999539047,1050,1101977
SoA heuristic,4240,3180,0.00017692852087756547,0.005457899998873472,1060,1121478
MMG,4240,3180,0.00017692852087756547,1.9220505999401212,1060,1121478
SoA heuristic,4400,3300,0.00017049329393043874,0.005805300083011389,1100,1210603
MMG,4400,3300,0.00017049329393043874,2.2443178000394255,1100,1210603
SoA heuristic,4600,3450,0.00016307893020221786,0.005914599867537618,1150,1324026
MMG,4600,3450,0.00016307893020221786,2.567917399806902,1150,1324026
SoA heuristic,4000,3000,0.00018754688672168043,0.006701300153508782,1000,999907
MMG,4000,3000,0.00018754688672168043,1.6979855000972748,1000,999907
SoA heuristic,4020,3015,0.00018661358546902214,0.004266700008884072,1005,1010311
MMG,4020,3015,0.00018661358546902214,1.9947810999583453,1005,1010311
SoA heuristic,4040,3030,0.00018568952711067095,0.0023108001332730055,1010,1018828
MMG,4040,3030,0.00018568952711067095,1.8974351999349892,1010,1018828
SoA heuristic,4080,3060,0.00018386859524393233,0.0025077001191675663,1020,1039118
MMG,4080,3060,0.00018386859524393233,2.071500799851492,1020,1039118
SoA heuristic,4120,3090,0.0001820830298616169,0.005829600151628256,1030,1061109
MMG,4120,3090,0.0001820830298616169,2.1334158000536263,1030,1061109
SoA heuristic,4200,3150,0.00017861395570373899,0.005658000009134412,1050,1102822
MMG,4200,3150,0.00017861395570373899,2.107137900078669,1050,1102822
SoA heuristic,4240,3180,0.00017692852087756547,0.004397199954837561,1060,1122404
MMG,4240,3180,0.00017692852087756547,2.0738651999272406,1060,1122404
SoA heuristic,4400,3300,0.00017049329393043874,0.0026247999630868435,1100,1208991
MMG,4400,3300,0.00017049329393043874,2.2237599999643862,1100,1208991
SoA heuristic,4600,3450,0.00016307893020221786,0.003860299941152334,1150,1323062
MMG,4600,3450,0.00016307893020221786,2.1189158998895437,1150,1323062
SoA heuristic,4000,3000,0.00018754688672168043,0.002163700060918927,1000,999942
MMG,4000,3000,0.00018754688672168043,1.6938768001273274,1000,999942
SoA heuristic,4020,3015,0.00018661358546902214,0.005271099973469973,1005,1010649
MMG,4020,3015,0.00018661358546902214,1.8892251998186111,1005,1010649
SoA heuristic,4040,3030,0.00018568952711067095,0.002158599905669689,1010,1019889
MMG,4040,3030,0.00018568952711067095,1.903639700030908,1010,1019889
SoA heuristic,4080,3060,0.00018386859524393233,0.002531799953430891,1020,1040358
MMG,4080,3060,0.00018386859524393233,1.8762705000117421,1020,1040358
SoA heuristic,4120,3090,0.0001820830298616169,0.0021307000424712896,1030,1060313
MMG,4120,3090,0.0001820830298616169,1.6818981000687927,1030,1060313
SoA heuristic,4200,3150,0.00017861395570373899,0.00442740018479526,1050,1102775
MMG,4200,3150,0.00017861395570373899,2.2389032000210136,1050,1102775
SoA heuristic,4240,3180,0.00017692852087756547,0.005684299860149622,1060,1122482
MMG,4240,3180,0.00017692852087756547,2.2043164998758584,1060,1122482
SoA heuristic,4400,3300,0.00017049329393043874,0.0023731000255793333,1100,1210637
MMG,4400,3300,0.00017049329393043874,2.049056800082326,1100,1210637
SoA heuristic,4600,3450,0.00016307893020221786,0.006236999994143844,1150,1322442
MMG,4600,3450,0.00016307893020221786,2.6009641001001,1150,1322442
SoA heuristic,4000,3000,0.00018754688672168043,0.006307200063019991,1000,998799
MMG,4000,3000,0.00018754688672168043,1.8421058000531048,1000,998799
SoA heuristic,4020,3015,0.00018661358546902214,0.002238699933513999,1005,1008807
MMG,4020,3015,0.00018661358546902214,1.8256811001338065,1005,1008807
SoA heuristic,4040,3030,0.00018568952711067095,0.006476699840277433,1010,1020809
MMG,4040,3030,0.00018568952711067095,1.9093376998789608,1010,1020809
SoA heuristic,4080,3060,0.00018386859524393233,0.0021473001688718796,1020,1040241
MMG,4080,3060,0.00018386859524393233,1.7976500999648124,1020,1040241
SoA heuristic,4120,3090,0.0001820830298616169,0.005714199971407652,1030,1060368
MMG,4120,3090,0.0001820830298616169,1.9837525999173522,1030,1060368
SoA heuristic,4200,3150,0.00017861395570373899,0.0043796999379992485,1050,1101228
MMG,4200,3150,0.00017861395570373899,2.119836799800396,1050,1101228
SoA heuristic,4240,3180,0.00017692852087756547,0.006098099984228611,1060,1124039
MMG,4240,3180,0.00017692852087756547,2.1189448998775333,1060,1124039
SoA heuristic,4400,3300,0.00017049329393043874,0.002789400052279234,1100,1208563
MMG,4400,3300,0.00017049329393043874,2.351342299953103,1100,1208563
SoA heuristic,4600,3450,0.00016307893020221786,0.0028536999598145485,1150,1321574
MMG,4600,3450,0.00016307893020221786,2.346109100151807,1150,1321574
SoA heuristic,4000,3000,0.00018754688672168043,0.0021913000382483006,1000,1001279
MMG,4000,3000,0.00018754688672168043,1.7459871999453753,1000,1001279
SoA heuristic,4020,3015,0.00018661358546902214,0.005825400119647384,1005,1011445
MMG,4020,3015,0.00018661358546902214,2.0134332000743598,1005,1011445
SoA heuristic,4040,3030,0.00018568952711067095,0.004415299976244569,1010,1019079
MMG,4040,3030,0.00018568952711067095,1.9037198999430984,1010,1019079
SoA heuristic,4080,3060,0.00018386859524393233,0.005553600145503879,1020,1041657
MMG,4080,3060,0.00018386859524393233,1.996945499908179,1020,1041657
SoA heuristic,4120,3090,0.0001820830298616169,0.0037147998809814453,1030,1062127
MMG,4120,3090,0.0001820830298616169,2.0986113999970257,1030,1062127
SoA heuristic,4200,3150,0.00017861395570373899,0.00812499993480742,1050,1102450
MMG,4200,3150,0.00017861395570373899,2.2511505000293255,1050,1102450
SoA heuristic,4240,3180,0.00017692852087756547,0.0038304999470710754,1060,1120737
MMG,4240,3180,0.00017692852087756547,2.2818855999503285,1060,1120737
SoA heuristic,4400,3300,0.00017049329393043874,0.007382000098004937,1100,1209212
MMG,4400,3300,0.00017049329393043874,2.250252600060776,1100,1209212
SoA heuristic,4600,3450,0.00016307893020221786,0.003148999996483326,1150,1321291
MMG,4600,3450,0.00016307893020221786,2.3495819000527263,1150,1321291
SoA heuristic,4000,3000,0.00018754688672168043,0.0036623000632971525,1000,999929
MMG,4000,3000,0.00018754688672168043,1.6686780999880284,1000,999929
SoA heuristic,4020,3015,0.00018661358546902214,0.0021875998936593533,1005,1010203
MMG,4020,3015,0.00018661358546902214,1.642928299959749,1005,1010203
SoA heuristic,4040,3030,0.00018568952711067095,0.007015499984845519,1010,1021820
MMG,4040,3030,0.00018568952711067095,1.8705597000662237,1010,1021820
SoA heuristic,4080,3060,0.00018386859524393233,0.002239199820905924,1020,1042629
MMG,4080,3060,0.00018386859524393233,1.82370449998416,1020,1042629
SoA heuristic,4120,3090,0.0001820830298616169,0.0028850999660789967,1030,1062304
MMG,4120,3090,0.0001820830298616169,1.7178746999707073,1030,1062304
SoA heuristic,4200,3150,0.00017861395570373899,0.0027646999806165695,1050,1102235
MMG,4200,3150,0.00017861395570373899,1.8631478999741375,1050,1102235
SoA heuristic,4240,3180,0.00017692852087756547,0.0023490998428314924,1060,1123944
MMG,4240,3180,0.00017692852087756547,1.9342873999848962,1060,1123944
SoA heuristic,4400,3300,0.00017049329393043874,0.007822400191798806,1100,1210149
MMG,4400,3300,0.00017049329393043874,2.216103399870917,1100,1210149
SoA heuristic,4600,3450,0.00016307893020221786,0.007775699952617288,1150,1320699
MMG,4600,3450,0.00016307893020221786,2.209699499886483,1150,1320699
SoA heuristic,4000,3000,0.00018754688672168043,0.002251999918371439,1000,998556
MMG,4000,3000,0.00018754688672168043,1.4549805999267846,1000,998556
SoA heuristic,4020,3015,0.00018661358546902214,0.005478399805724621,1005,1010411
MMG,4020,3015,0.00018661358546902214,1.5105679999105632,1005,1010411
SoA heuristic,4040,3030,0.00018568952711067095,0.0025621000677347183,1010,1020339
MMG,4040,3030,0.00018568952711067095,1.7527970001101494,1010,1020339
SoA heuristic,4080,3060,0.00018386859524393233,0.002273899968713522,1020,1040623
MMG,4080,3060,0.00018386859524393233,1.8835633001290262,1020,1040623
SoA heuristic,4120,3090,0.0001820830298616169,0.0021863000001758337,1030,1063440
MMG,4120,3090,0.0001820830298616169,1.8614042999688536,1030,1063440
SoA heuristic,4200,3150,0.00017861395570373899,0.0039385000709444284,1050,1103590
MMG,4200,3150,0.00017861395570373899,1.9489603000693023,1050,1103590
SoA heuristic,4240,3180,0.00017692852087756547,0.0023162998259067535,1060,1123801
MMG,4240,3180,0.00017692852087756547,1.8856661000754684,1060,1123801
SoA heuristic,4400,3300,0.00017049329393043874,0.00251140003092587,1100,1210619
MMG,4400,3300,0.00017049329393043874,1.8469901999924332,1100,1210619
SoA heuristic,4600,3450,0.00016307893020221786,0.006736499955877662,1150,1321070
MMG,4600,3450,0.00016307893020221786,2.2447844999842346,1150,1321070
SoA heuristic,4000,3000,0.00018754688672168043,0.002512100152671337,1000,1000600
MMG,4000,3000,0.00018754688672168043,1.8231504999566823,1000,1000600
SoA heuristic,4020,3015,0.00018661358546902214,0.006526600103825331,1005,1009260
MMG,4020,3015,0.00018661358546902214,1.9676113000605255,1005,1009260
SoA heuristic,4040,3030,0.00018568952711067095,0.006207500118762255,1010,1019536
MMG,4040,3030,0.00018568952711067095,1.9079150999896228,1010,1019536
SoA heuristic,4080,3060,0.00018386859524393233,0.0021983999758958817,1020,1041021
MMG,4080,3060,0.00018386859524393233,1.8990746000781655,1020,1041021
SoA heuristic,4120,3090,0.0001820830298616169,0.005747599992901087,1030,1059500
MMG,4120,3090,0.0001820830298616169,2.2059021999593824,1030,1059500
SoA heuristic,4200,3150,0.00017861395570373899,0.006125899963080883,1050,1101502
MMG,4200,3150,0.00017861395570373899,2.107041300041601,1050,1101502
SoA heuristic,4240,3180,0.00017692852087756547,0.04415460000745952,1060,1123194
MMG,4240,3180,0.00017692852087756547,2.115118999965489,1060,1123194
SoA heuristic,4400,3300,0.00017049329393043874,0.0028336001560091972,1100,1207748
MMG,4400,3300,0.00017049329393043874,2.1186790000647306,1100,1207748
SoA heuristic,4600,3450,0.00016307893020221786,0.0024470998905599117,1150,1322764
MMG,4600,3450,0.00016307893020221786,2.4782404999714345,1150,1322764
SoA heuristic,4000,3000,0.00018754688672168043,0.0020967000164091587,1000,998879
MMG,4000,3000,0.00018754688672168043,1.552307500038296,1000,998879
SoA heuristic,4020,3015,0.00018661358546902214,0.006320600165054202,1005,1010150
MMG,4020,3015,0.00018661358546902214,1.602031199960038,1005,1010150
SoA heuristic,4040,3030,0.00018568952711067095,0.002141800010576844,1010,1019959
MMG,4040,3030,0.00018568952711067095,1.6485800999216735,1010,1019959
SoA heuristic,4080,3060,0.00018386859524393233,0.002660400001332164,1020,1039994
MMG,4080,3060,0.00018386859524393233,1.58876770013012,1020,1039994
SoA heuristic,4120,3090,0.0001820830298616169,0.007982300128787756,1030,1062229
MMG,4120,3090,0.0001820830298616169,1.5979597000405192,1030,1062229
SoA heuristic,4200,3150,0.00017861395570373899,0.0024967000354081392,1050,1102323
MMG,4200,3150,0.00017861395570373899,1.6944603000301868,1050,1102323
SoA heuristic,4240,3180,0.00017692852087756547,0.0022534001618623734,1060,1123563
MMG,4240,3180,0.00017692852087756547,1.6957722001243383,1060,1123563
SoA heuristic,4400,3300,0.00017049329393043874,0.0076611998956650496,1100,1209765
MMG,4400,3300,0.00017049329393043874,1.986585200065747,1100,1209765
SoA heuristic,4600,3450,0.00016307893020221786,0.008508400060236454,1150,1323658
MMG,4600,3450,0.00016307893020221786,2.345704600214958,1150,1323658
SoA heuristic,4000,3000,0.00018754688672168043,0.0024501001462340355,1000,999736
MMG,4000,3000,0.00018754688672168043,1.4448003999423236,1000,999736
SoA heuristic,4020,3015,0.00018661358546902214,0.006132599897682667,1005,1011753
MMG,4020,3015,0.00018661358546902214,1.7204212001524866,1005,1011753
SoA heuristic,4040,3030,0.00018568952711067095,0.0031131000723689795,1010,1020807
MMG,4040,3030,0.00018568952711067095,1.724976799916476,1010,1020807
SoA heuristic,4080,3060,0.00018386859524393233,0.004228400066494942,1020,1040467
MMG,4080,3060,0.00018386859524393233,1.7126825999002904,1020,1040467
SoA heuristic,4120,3090,0.0001820830298616169,0.0027258999180048704,1030,1060428
MMG,4120,3090,0.0001820830298616169,1.7280645999126136,1030,1060428
SoA heuristic,4200,3150,0.00017861395570373899,0.0059442000929266214,1050,1102785
MMG,4200,3150,0.00017861395570373899,1.7105952999554574,1050,1102785
SoA heuristic,4240,3180,0.00017692852087756547,0.034170900005847216,1060,1123496
MMG,4240,3180,0.00017692852087756547,1.7585472001228482,1060,1123496
SoA heuristic,4400,3300,0.00017049329393043874,0.005785399815067649,1100,1210444
MMG,4400,3300,0.00017049329393043874,1.8726664998102933,1100,1210444
SoA heuristic,4600,3450,0.00016307893020221786,0.006362600019201636,1150,1323604
MMG,4600,3450,0.00016307893020221786,2.037062200019136,1150,1323604
SoA heuristic,4000,3000,0.00018754688672168043,0.007216100115329027,1000,998537
MMG,4000,3000,0.00018754688672168043,3.721586000174284,1000,998537
SoA heuristic,4020,3015,0.00018661358546902214,0.009860299993306398,1005,1009927
MMG,4020,3015,0.00018661358546902214,3.866792199900374,1005,1009927
SoA heuristic,4040,3030,0.00018568952711067095,0.007204100023955107,1010,1018793
MMG,4040,3030,0.00018568952711067095,3.7046175999566913,1010,1018793
SoA heuristic,4080,3060,0.00018386859524393233,0.008621899876743555,1020,1040995
MMG,4080,3060,0.00018386859524393233,3.79731549997814,1020,1040995
SoA heuristic,4120,3090,0.0001820830298616169,0.00713829998858273,1030,1062251
MMG,4120,3090,0.0001820830298616169,4.011195300146937,1030,1062251
SoA heuristic,4200,3150,0.00017861395570373899,0.008872200036421418,1050,1102986
MMG,4200,3150,0.00017861395570373899,4.024708099896088,1050,1102986
SoA heuristic,4240,3180,0.00017692852087756547,0.0075012999586761,1060,1122775
MMG,4240,3180,0.00017692852087756547,4.186977099860087,1060,1122775
SoA heuristic,4400,3300,0.00017049329393043874,0.008264200063422322,1100,1210509
MMG,4400,3300,0.00017049329393043874,4.40111290011555,1100,1210509
SoA heuristic,4600,3450,0.00016307893020221786,0.00856980006210506,1150,1324978
MMG,4600,3450,0.00016307893020221786,4.81494880001992,1150,1324978
SoA heuristic,4000,3000,0.00018754688672168043,0.007071699947118759,1000,1000239
MMG,4000,3000,0.00018754688672168043,3.6569421999156475,1000,1000239
SoA heuristic,4020,3015,0.00018661358546902214,0.006994399940595031,1005,1010696
MMG,4020,3015,0.00018661358546902214,3.6617962999735028,1005,1010696
SoA heuristic,4040,3030,0.00018568952711067095,0.007817500038072467,1010,1021665
MMG,4040,3030,0.00018568952711067095,3.816257399972528,1010,1021665
SoA heuristic,4080,3060,0.00018386859524393233,0.007403300143778324,1020,1041331
MMG,4080,3060,0.00018386859524393233,3.818762500071898,1020,1041331
SoA heuristic,4120,3090,0.0001820830298616169,0.006981800077483058,1030,1060424
MMG,4120,3090,0.0001820830298616169,3.956957000074908,1030,1060424
SoA heuristic,4200,3150,0.00017861395570373899,0.007243599975481629,1050,1103031
MMG,4200,3150,0.00017861395570373899,4.054069500183687,1050,1103031
SoA heuristic,4240,3180,0.00017692852087756547,0.007701599970459938,1060,1123220
MMG,4240,3180,0.00017692852087756547,4.189747600117698,1060,1123220
SoA heuristic,4400,3300,0.00017049329393043874,0.007815399905666709,1100,1209082
MMG,4400,3300,0.00017049329393043874,4.501662499969825,1100,1209082
SoA heuristic,4600,3450,0.00016307893020221786,0.008367399917915463,1150,1321031
MMG,4600,3450,0.00016307893020221786,4.890366100007668,1150,1321031
SoA heuristic,4000,3000,0.00018754688672168043,0.0023427000269293785,1000,1000609
MMG,4000,3000,0.00018754688672168043,1.1843909998424351,1000,1000609
SoA heuristic,4020,3015,0.00018661358546902214,0.0022466001100838184,1005,1011324
MMG,4020,3015,0.00018661358546902214,1.2000406000297517,1005,1011324
SoA heuristic,4040,3030,0.00018568952711067095,0.003294799942523241,1010,1019370
MMG,4040,3030,0.00018568952711067095,1.2049718999769539,1010,1019370
SoA heuristic,4080,3060,0.00018386859524393233,0.002276899991557002,1020,1040770
MMG,4080,3060,0.00018386859524393233,1.2931735999882221,1020,1040770
SoA heuristic,4120,3090,0.0001820830298616169,0.002871900098398328,1030,1060444
MMG,4120,3090,0.0001820830298616169,1.2673186000902206,1030,1060444
SoA heuristic,4200,3150,0.00017861395570373899,0.0026555999647825956,1050,1104516
MMG,4200,3150,0.00017861395570373899,1.313302399823442,1050,1104516
SoA heuristic,4240,3180,0.00017692852087756547,0.028805800015106797,1060,1121602
MMG,4240,3180,0.00017692852087756547,1.3334555998444557,1060,1121602
SoA heuristic,4400,3300,0.00017049329393043874,0.0026960999239236116,1100,1209937
MMG,4400,3300,0.00017049329393043874,1.4736190000548959,1100,1209937
SoA heuristic,4600,3450,0.00016307893020221786,0.00272650015540421,1150,1324214
MMG,4600,3450,0.00016307893020221786,1.5877939001657069,1150,1324214
SoA heuristic,4000,3000,0.00018754688672168043,0.0022934998851269484,1000,999607
MMG,4000,3000,0.00018754688672168043,1.1411736998707056,1000,999607
SoA heuristic,4020,3015,0.00018661358546902214,0.0026581999845802784,1005,1008528
MMG,4020,3015,0.00018661358546902214,1.2070069999899715,1005,1008528
SoA heuristic,4040,3030,0.00018568952711067095,0.002486799843609333,1010,1020297
MMG,4040,3030,0.00018568952711067095,1.2161323998589069,1010,1020297
SoA heuristic,4080,3060,0.00018386859524393233,0.003073400119319558,1020,1040357
MMG,4080,3060,0.00018386859524393233,1.2985165000427514,1020,1040357
SoA heuristic,4120,3090,0.0001820830298616169,0.0024055999238044024,1030,1059108
MMG,4120,3090,0.0001820830298616169,1.2718902002088726,1030,1059108
SoA heuristic,4200,3150,0.00017861395570373899,0.002752699889242649,1050,1101867
MMG,4200,3150,0.00017861395570373899,1.3304651000071317,1050,1101867
SoA heuristic,4240,3180,0.00017692852087756547,0.0025104000233113766,1060,1122691
MMG,4240,3180,0.00017692852087756547,1.3560749001335353,1060,1122691
SoA heuristic,4400,3300,0.00017049329393043874,0.0024474000092595816,1100,1210611
MMG,4400,3300,0.00017049329393043874,1.4787010999862105,1100,1210611
SoA heuristic,4600,3450,0.00016307893020221786,0.0025010001845657825,1150,1322654
MMG,4600,3450,0.00016307893020221786,1.6086345000658184,1150,1322654
SoA heuristic,4000,3000,0.00018754688672168043,0.0028850999660789967,1000,1001109
MMG,4000,3000,0.00018754688672168043,1.1925190999172628,1000,1001109
SoA heuristic,4020,3015,0.00018661358546902214,0.0025331999640911818,1005,1009473
MMG,4020,3015,0.00018661358546902214,1.2147115000989288,1005,1009473
SoA heuristic,4040,3030,0.00018568952711067095,0.002377399941906333,1010,1021735
MMG,4040,3030,0.00018568952711067095,1.2124724998138845,1010,1021735
SoA heuristic,4080,3060,0.00018386859524393233,0.002475700108334422,1020,1038559
MMG,4080,3060,0.00018386859524393233,1.2514998998958617,1020,1038559
SoA heuristic,4120,3090,0.0001820830298616169,0.0028389999642968178,1030,1060458
MMG,4120,3090,0.0001820830298616169,1.2120280000381172,1030,1060458
SoA heuristic,4200,3150,0.00017861395570373899,0.0023127999156713486,1050,1102361
MMG,4200,3150,0.00017861395570373899,1.3127218000590801,1050,1102361
SoA heuristic,4240,3180,0.00017692852087756547,0.00280330004170537,1060,1123841
MMG,4240,3180,0.00017692852087756547,1.3435399997979403,1060,1123841
SoA heuristic,4400,3300,0.00017049329393043874,0.0028401000890880823,1100,1208940
MMG,4400,3300,0.00017049329393043874,1.4570715001318604,1100,1208940
SoA heuristic,4600,3450,0.00016307893020221786,0.0030610000248998404,1150,1323256
MMG,4600,3450,0.00016307893020221786,1.5538578000850976,1150,1323256
SoA heuristic,4000,3000,0.00018754688672168043,0.00290270010009408,1000,1000546
MMG,4000,3000,0.00018754688672168043,1.204518900020048,1000,1000546
SoA heuristic,4020,3015,0.00018661358546902214,0.002467299811542034,1005,1009227
MMG,4020,3015,0.00018661358546902214,1.2143200999125838,1005,1009227
SoA heuristic,4040,3030,0.00018568952711067095,0.002344599924981594,1010,1021948
MMG,4040,3030,0.00018568952711067095,1.2224316000938416,1010,1021948
SoA heuristic,4080,3060,0.00018386859524393233,0.0023206002078950405,1020,1040642
MMG,4080,3060,0.00018386859524393233,1.27329790010117,1020,1040642
SoA heuristic,4120,3090,0.0001820830298616169,0.0028363000601530075,1030,1060721
MMG,4120,3090,0.0001820830298616169,1.2520945998840034,1030,1060721
SoA heuristic,4200,3150,0.00017861395570373899,0.002359400037676096,1050,1101665
MMG,4200,3150,0.00017861395570373899,1.3180406000465155,1050,1101665
SoA heuristic,4240,3180,0.00017692852087756547,0.0028950998093932867,1060,1123054
MMG,4240,3180,0.00017692852087756547,1.299170299898833,1060,1123054
SoA heuristic,4400,3300,0.00017049329393043874,0.0029108000453561544,1100,1209078
MMG,4400,3300,0.00017049329393043874,1.500025800196454,1100,1209078
SoA heuristic,4600,3450,0.00016307893020221786,0.002635199809446931,1150,1322591
MMG,4600,3450,0.00016307893020221786,1.5386910000815988,1150,1322591
SoA heuristic,4000,3000,0.00018754688672168043,0.002187199890613556,1000,1000108
MMG,4000,3000,0.00018754688672168043,1.2021520999260247,1000,1000108
SoA heuristic,4020,3015,0.00018661358546902214,0.0035053000319749117,1005,1009849
MMG,4020,3015,0.00018661358546902214,1.2179938000626862,1005,1009849
SoA heuristic,4040,3030,0.00018568952711067095,0.0021709001157432795,1010,1020707
MMG,4040,3030,0.00018568952711067095,1.153645700076595,1010,1020707
SoA heuristic,4080,3060,0.00018386859524393233,0.0027522000018507242,1020,1039951
MMG,4080,3060,0.00018386859524393233,1.2379481999669224,1020,1039951
SoA heuristic,4120,3090,0.0001820830298616169,0.002611400093883276,1030,1059255
MMG,4120,3090,0.0001820830298616169,1.2410452000331134,1030,1059255
SoA heuristic,4200,3150,0.00017861395570373899,0.0026378000620752573,1050,1103160
MMG,4200,3150,0.00017861395570373899,1.3291138999629766,1050,1103160
SoA heuristic,4240,3180,0.00017692852087756547,0.0024809997994452715,1060,1123307
MMG,4240,3180,0.00017692852087756547,1.3583343999926,1060,1123307
SoA heuristic,4400,3300,0.00017049329393043874,0.002582099987193942,1100,1210822
MMG,4400,3300,0.00017049329393043874,1.498339100042358,1100,1210822
SoA heuristic,4600,3450,0.00016307893020221786,0.002749399980530143,1150,1322216
MMG,4600,3450,0.00016307893020221786,1.606667400104925,1150,1322216
SoA heuristic,4000,3000,0.00018754688672168043,0.0022620998788625,1000,998970
MMG,4000,3000,0.00018754688672168043,1.1899570999667048,1000,998970
SoA heuristic,4020,3015,0.00018661358546902214,0.002821400063112378,1005,1009025
MMG,4020,3015,0.00018661358546902214,1.2167835000436753,1005,1009025
SoA heuristic,4040,3030,0.00018568952711067095,0.0023429999127984047,1010,1019664
MMG,4040,3030,0.00018568952711067095,1.231734599918127,1010,1019664
SoA heuristic,4080,3060,0.00018386859524393233,0.0029019000940024853,1020,1040998
MMG,4080,3060,0.00018386859524393233,1.2865222000982612,1020,1040998
SoA heuristic,4120,3090,0.0001820830298616169,0.0024306001141667366,1030,1060018
MMG,4120,3090,0.0001820830298616169,1.2097887999843806,1030,1060018
SoA heuristic,4200,3150,0.00017861395570373899,0.002589099807664752,1050,1102347
MMG,4200,3150,0.00017861395570373899,1.3167536000255495,1050,1102347
SoA heuristic,4240,3180,0.00017692852087756547,0.0025198999792337418,1060,1122758
MMG,4240,3180,0.00017692852087756547,1.3556189998053014,1060,1122758
SoA heuristic,4400,3300,0.00017049329393043874,0.0025689001195132732,1100,1211745
MMG,4400,3300,0.00017049329393043874,1.5062512999866158,1100,1211745
SoA heuristic,4600,3450,0.00016307893020221786,0.0026886998675763607,1150,1323326
MMG,4600,3450,0.00016307893020221786,1.5260161000769585,1150,1323326
SoA heuristic,4000,3000,0.00018754688672168043,0.0023579001426696777,1000,998968
MMG,4000,3000,0.00018754688672168043,1.1755754000041634,1000,998968
SoA heuristic,4020,3015,0.00018661358546902214,0.0027176998555660248,1005,1009496
MMG,4020,3015,0.00018661358546902214,1.1531813000328839,1005,1009496
SoA heuristic,4040,3030,0.00018568952711067095,0.0021504999604076147,1010,1019437
MMG,4040,3030,0.00018568952711067095,1.2736263000406325,1010,1019437
SoA heuristic,4080,3060,0.00018386859524393233,0.0036816000938415527,1020,1041454
MMG,4080,3060,0.00018386859524393233,1.2602373000700027,1020,1041454
SoA heuristic,4120,3090,0.0001820830298616169,0.002454400062561035,1030,1062525
MMG,4120,3090,0.0001820830298616169,1.2928130999207497,1030,1062525
SoA heuristic,4200,3150,0.00017861395570373899,0.0026712999679148197,1050,1102366
MMG,4200,3150,0.00017861395570373899,1.31790960021317,1050,1102366
SoA heuristic,4240,3180,0.00017692852087756547,0.00261049997061491,1060,1122919
MMG,4240,3180,0.00017692852087756547,1.4003422998357564,1060,1122919
SoA heuristic,4400,3300,0.00017049329393043874,0.002459899988025427,1100,1210337
MMG,4400,3300,0.00017049329393043874,1.48260959982872,1100,1210337
SoA heuristic,4600,3450,0.00016307893020221786,0.0026895999908447266,1150,1324260
MMG,4600,3450,0.00016307893020221786,1.5949013999197632,1150,1324260
SoA heuristic,4000,3000,0.00018754688672168043,0.002416500123217702,1000,1000605
MMG,4000,3000,0.00018754688672168043,1.1970891999080777,1000,1000605
SoA heuristic,4020,3015,0.00018661358546902214,0.002940499922260642,1005,1011047
MMG,4020,3015,0.00018661358546902214,1.2160187000408769,1005,1011047
SoA heuristic,4040,3030,0.00018568952711067095,0.003145199967548251,1010,1018759
MMG,4040,3030,0.00018568952711067095,1.2598476000130177,1010,1018759
SoA heuristic,4080,3060,0.00018386859524393233,0.00280930008739233,1020,1039023
MMG,4080,3060,0.00018386859524393233,1.253808599896729,1020,1039023
SoA heuristic,4120,3090,0.0001820830298616169,0.0024404998403042555,1030,1061367
MMG,4120,3090,0.0001820830298616169,1.2651893999427557,1030,1061367
SoA heuristic,4200,3150,0.00017861395570373899,0.0023733999114483595,1050,1101333
MMG,4200,3150,0.00017861395570373899,1.2517741001211107,1050,1101333
SoA heuristic,4240,3180,0.00017692852087756547,0.002850000048056245,1060,1123020
MMG,4240,3180,0.00017692852087756547,1.356643500039354,1060,1123020
SoA heuristic,4400,3300,0.00017049329393043874,0.002409399952739477,1100,1210202
MMG,4400,3300,0.00017049329393043874,1.4623810001648962,1100,1210202
SoA heuristic,4600,3450,0.00016307893020221786,0.0027474998496472836,1150,1322198
MMG,4600,3450,0.00016307893020221786,1.6027808000799268,1150,1322198
SoA heuristic,4000,3000,0.00018754688672168043,0.002251999918371439,1000,1000019
MMG,4000,3000,0.00018754688672168043,1.1385673999320716,1000,1000019
SoA heuristic,4020,3015,0.00018661358546902214,0.0021961999591439962,1005,1009726
MMG,4020,3015,0.00018661358546902214,1.2071585000958294,1005,1009726
SoA heuristic,4040,3030,0.00018568952711067095,0.002769900020211935,1010,1021224
MMG,4040,3030,0.00018568952711067095,1.2333174999803305,1010,1021224
SoA heuristic,4080,3060,0.00018386859524393233,0.0022579000797122717,1020,1042100
MMG,4080,3060,0.00018386859524393233,1.2508929001633078,1020,1042100
SoA heuristic,4120,3090,0.0001820830298616169,0.0027881998103111982,1030,1061444
MMG,4120,3090,0.0001820830298616169,1.2140096998773515,1030,1061444
SoA heuristic,4200,3150,0.00017861395570373899,0.002264800015836954,1050,1102395
MMG,4200,3150,0.00017861395570373899,1.265520699787885,1050,1102395
SoA heuristic,4240,3180,0.00017692852087756547,0.0024087000638246536,1060,1123524
MMG,4240,3180,0.00017692852087756547,1.3221169000025839,1060,1123524
SoA heuristic,4400,3300,0.00017049329393043874,0.0026228998322039843,1100,1208958
MMG,4400,3300,0.00017049329393043874,1.5031288999598473,1100,1208958
SoA heuristic,4600,3450,0.00016307893020221786,0.0028668001759797335,1150,1322399
MMG,4600,3450,0.00016307893020221786,1.5983805998694152,1150,1322399
SoA heuristic,4000,3000,0.00018754688672168043,0.002309700008481741,1000,1000018
MMG,4000,3000,0.00018754688672168043,1.2842732998542488,1000,1000018
SoA heuristic,4020,3015,0.00018661358546902214,0.0022450999822467566,1005,1010429
MMG,4020,3015,0.00018661358546902214,1.2809822000563145,1005,1010429
SoA heuristic,4040,3030,0.00018568952711067095,0.0024156998842954636,1010,1020545
MMG,4040,3030,0.00018568952711067095,1.3332094999495894,1010,1020545
SoA heuristic,4080,3060,0.00018386859524393233,0.003010400105267763,1020,1042625
MMG,4080,3060,0.00018386859524393233,1.3667224999517202,1020,1042625
SoA heuristic,4120,3090,0.0001820830298616169,0.0025868997909128666,1030,1062051
MMG,4120,3090,0.0001820830298616169,1.3994493000209332,1030,1062051
SoA heuristic,4200,3150,0.00017861395570373899,0.0024470000062137842,1050,1103008
MMG,4200,3150,0.00017861395570373899,1.4474245000164956,1050,1103008
SoA heuristic,4240,3180,0.00017692852087756547,0.003261800156906247,1060,1125629
MMG,4240,3180,0.00017692852087756547,1.4295155999716371,1060,1125629
SoA heuristic,4400,3300,0.00017049329393043874,0.004186799982562661,1100,1210365
MMG,4400,3300,0.00017049329393043874,1.5334936999715865,1100,1210365
SoA heuristic,4600,3450,0.00016307893020221786,0.0035511001478880644,1150,1322300
MMG,4600,3450,0.00016307893020221786,1.6610757999587804,1150,1322300
