name,nodes,edges,density,time,result_set,result_w
SoA heuristic,20,15,0.039473684210526314,5.45999500900507e-05,5,14
MMG,20,15,0.039473684210526314,0.00032839993946254253,5,14
SoA heuristic,40,30,0.019230769230769232,3.8499943912029266e-05,10,54
MMG,40,30,0.019230769230769232,0.00024770013988018036,10,54
SoA heuristic,100,75,0.007575757575757576,6.46000262349844e-05,25,330
MMG,100,75,0.007575757575757576,0.000911500072106719,25,330
SoA heuristic,200,150,0.0037688442211055275,0.00016619986854493618,50,1260
MMG,200,150,0.0037688442211055275,0.003159899963065982,50,1260
SoA heuristic,400,300,0.0018796992481203006,0.00020570005290210247,100,4929
MMG,400,300,0.0018796992481203006,0.012170600006356835,100,4929
SoA heuristic,600,450,0.0012520868113522537,0.00029930006712675095,150,11237
MMG,600,450,0.0012520868113522537,0.040940399980172515,150,11237
SoA heuristic,1000,750,0.0007507507507507507,0.000960799865424633,250,31220
MMG,1000,750,0.0007507507507507507,0.08424220001325011,250,31220
SoA heuristic,2000,1500,0.00037518759379689845,0.0035641000140458345,500,124855
MMG,2000,1500,0.00037518759379689845,0.46605950011871755,500,124855
SoA heuristic,4000,3000,0.00018754688672168043,0.003757700091227889,1000,499287
MMG,4000,3000,0.00018754688672168043,1.5840479000471532,1000,499287
SoA heuristic,8000,6000,9.376172021502688e-05,0.0058750000316649675,2000,1999887
MMG,8000,6000,9.376172021502688e-05,6.293395600048825,2000,1999887
SoA heuristic,20,15,0.039473684210526314,3.390014171600342e-05,5,15
MMG,20,15,0.039473684210526314,0.00010249996557831764,5,15
SoA heuristic,40,30,0.019230769230769232,3.400002606213093e-05,10,55
MMG,40,30,0.019230769230769232,0.0002229998353868723,10,55
SoA heuristic,100,75,0.007575757575757576,7.309997454285622e-05,25,332
MMG,100,75,0.007575757575757576,0.002647299785166979,25,332
SoA heuristic,200,150,0.0037688442211055275,0.00013129995204508305,50,1222
MMG,200,150,0.0037688442211055275,0.005065300036221743,50,1222
SoA heuristic,400,300,0.0018796992481203006,0.0002842999529093504,100,5050
MMG,400,300,0.0018796992481203006,0.013932600151747465,100,5050
SoA heuristic,600,450,0.0012520868113522537,0.0005607998464256525,150,11269
MMG,600,450,0.0012520868113522537,0.02771779987961054,150,11269
SoA heuristic,1000,750,0.0007507507507507507,0.0006699999794363976,250,31167
MMG,1000,750,0.0007507507507507507,0.07855249987915158,250,31167
SoA heuristic,2000,1500,0.00037518759379689845,0.001196900149807334,500,124855
MMG,2000,1500,0.00037518759379689845,0.34352380014024675,500,124855
SoA heuristic,4000,3000,0.00018754688672168043,0.0424065999686718,1000,500297
MMG,4000,3000,0.00018754688672168043,1.8881609998643398,1000,500297
SoA heuristic,8000,6000,9.376172021502688e-05,0.0075853001326322556,2000,2000414
MMG,8000,6000,9.376172021502688e-05,6.829480099957436,2000,2000414
SoA heuristic,20,15,0.039473684210526314,3.3800024539232254e-05,5,13
MMG,20,15,0.039473684210526314,0.00011479994282126427,5,13
SoA heuristic,40,30,0.019230769230769232,3.900006413459778e-05,10,57
MMG,40,30,0.019230769230769232,0.0002874999772757292,10,57
SoA heuristic,100,75,0.007575757575757576,5.859998054802418e-05,25,303
MMG,100,75,0.007575757575757576,0.0009045999031513929,25,303
SoA heuristic,200,150,0.0037688442211055275,0.00030519999563694,50,1265
MMG,200,150,0.0037688442211055275,0.008902400033548474,50,1265
SoA heuristic,400,300,0.0018796992481203006,0.0003621000796556473,100,4954
MMG,400,300,0.0018796992481203006,0.011628200067207217,100,4954
SoA heuristic,600,450,0.0012520868113522537,0.0006644998211413622,150,11193
MMG,600,450,0.0012520868113522537,0.02474580006673932,150,11193
SoA heuristic,1000,750,0.0007507507507507507,0.0008514001965522766,250,31142
MMG,1000,750,0.0007507507507507507,0.12477390002459288,250,31142
SoA heuristic,2000,1500,0.00037518759379689845,0.002954200142994523,500,124925
MMG,2000,1500,0.00037518759379689845,0.4309402999933809,500,124925
SoA heuristic,4000,3000,0.00018754688672168043,0.0028472000267356634,1000,500037
MMG,4000,3000,0.00018754688672168043,1.9477521998342127,1000,500037
SoA heuristic,8000,6000,9.376172021502688e-05,0.018172699958086014,2000,1999500
MMG,8000,6000,9.376172021502688e-05,7.532545699970797,2000,1999500
SoA heuristic,20,15,0.039473684210526314,3.91998328268528e-05,5,13
MMG,20,15,0.039473684210526314,0.00010599987581372261,5,13
SoA heuristic,40,30,0.019230769230769232,5.149981006979942e-05,10,55
MMG,40,30,0.019230769230769232,0.0003426000475883484,10,55
SoA heuristic,100,75,0.007575757575757576,6.560003384947777e-05,25,304
MMG,100,75,0.007575757575757576,0.0009439999703317881,25,304
SoA heuristic,200,150,0.0037688442211055275,0.00011370005086064339,50,1224
MMG,200,150,0.0037688442211055275,0.003263800172135234,50,1224
SoA heuristic,400,300,0.0018796992481203006,0.00031029991805553436,100,5087
MMG,400,300,0.0018796992481203006,0.018720199819654226,100,5087
SoA heuristic,600,450,0.0012520868113522537,0.0004977001808583736,150,11337
MMG,600,450,0.0012520868113522537,0.04264679993502796,150,11337
SoA heuristic,1000,750,0.0007507507507507507,0.0009494998957961798,250,31043
MMG,1000,750,0.0007507507507507507,0.12376470002345741,250,31043
SoA heuristic,2000,1500,0.00037518759379689845,0.0019968999549746513,500,125062
MMG,2000,1500,0.00037518759379689845,0.5178071998525411,500,125062
SoA heuristic,4000,3000,0.00018754688672168043,0.004514000145718455,1000,500090
MMG,4000,3000,0.00018754688672168043,1.7082191000226885,1000,500090
SoA heuristic,8000,6000,9.376172021502688e-05,0.07157299993559718,2000,2000163
MMG,8000,6000,9.376172021502688e-05,7.856722800061107,2000,2000163
SoA heuristic,20,15,0.039473684210526314,3.809994086623192e-05,5,13
MMG,20,15,0.039473684210526314,0.00013980013318359852,5,13
SoA heuristic,40,30,0.019230769230769232,4.469999112188816e-05,10,46
MMG,40,30,0.019230769230769232,0.00028719985857605934,10,46
SoA heuristic,100,75,0.007575757575757576,7.800012826919556e-05,25,294
MMG,100,75,0.007575757575757576,0.0011593000963330269,25,294
SoA heuristic,200,150,0.0037688442211055275,0.00013010017573833466,50,1248
MMG,200,150,0.0037688442211055275,0.003755599958822131,50,1248
SoA heuristic,400,300,0.0018796992481203006,0.0002582001034170389,100,4983
MMG,400,300,0.0018796992481203006,0.014127100119367242,100,4983
SoA heuristic,600,450,0.0012520868113522537,0.0003790000919252634,150,11211
MMG,600,450,0.0012520868113522537,0.030334800016134977,150,11211
SoA heuristic,1000,750,0.0007507507507507507,0.0007122999522835016,250,31201
MMG,1000,750,0.0007507507507507507,0.09069420001469553,250,31201
SoA heuristic,2000,1500,0.00037518759379689845,0.0013928001280874014,500,124976
MMG,2000,1500,0.00037518759379689845,0.33318690001033247,500,124976
SoA heuristic,4000,3000,0.00018754688672168043,0.002794800093397498,1000,499754
MMG,4000,3000,0.00018754688672168043,1.368203999940306,1000,499754
SoA heuristic,8000,6000,9.376172021502688e-05,0.00582570000551641,2000,1999956
MMG,8000,6000,9.376172021502688e-05,5.593868299853057,2000,1999956
SoA heuristic,20,15,0.039473684210526314,3.6899931728839874e-05,5,13
MMG,20,15,0.039473684210526314,0.00014199991710484028,5,13
SoA heuristic,40,30,0.019230769230769232,4.0899962186813354e-05,10,57
MMG,40,30,0.019230769230769232,0.0002872999757528305,10,57
SoA heuristic,100,75,0.007575757575757576,7.770000956952572e-05,25,309
MMG,100,75,0.007575757575757576,0.0012298000510782003,25,309
SoA heuristic,200,150,0.0037688442211055275,0.00013820012100040913,50,1253
MMG,200,150,0.0037688442211055275,0.004052399890497327,50,1253
SoA heuristic,400,300,0.0018796992481203006,0.0002707999665290117,100,4960
MMG,400,300,0.0018796992481203006,0.01621500006876886,100,4960
SoA heuristic,600,450,0.0012520868113522537,0.0004078999627381563,150,11158
MMG,600,450,0.0012520868113522537,0.0334030999802053,150,11158
SoA heuristic,1000,750,0.0007507507507507507,0.0007739998400211334,250,31102
MMG,1000,750,0.0007507507507507507,0.08840769995003939,250,31102
SoA heuristic,2000,1500,0.00037518759379689845,0.0013864999637007713,500,124719
MMG,2000,1500,0.00037518759379689845,0.3452604999765754,500,124719
SoA heuristic,4000,3000,0.00018754688672168043,0.002890300005674362,1000,499809
MMG,4000,3000,0.00018754688672168043,1.4079965997952968,1000,499809
SoA heuristic,8000,6000,9.376172021502688e-05,0.04018980008549988,2000,2000634
MMG,8000,6000,9.376172021502688e-05,5.7504759998992085,2000,2000634
SoA heuristic,20,15,0.039473684210526314,3.809994086623192e-05,5,14
MMG,20,15,0.039473684210526314,9.320001117885113e-05,5,14
SoA heuristic,40,30,0.019230769230769232,6.740004755556583e-05,10,44
MMG,40,30,0.019230769230769232,0.00031240005046129227,10,44
SoA heuristic,100,75,0.007575757575757576,5.989987403154373e-05,25,308
MMG,100,75,0.007575757575757576,0.0010089999996125698,25,308
SoA heuristic,200,150,0.0037688442211055275,0.00015950016677379608,50,1213
MMG,200,150,0.0037688442211055275,0.0035327000077813864,50,1213
SoA heuristic,400,300,0.0018796992481203006,0.00021249987185001373,100,5069
MMG,400,300,0.0018796992481203006,0.01140669989399612,100,5069
SoA heuristic,600,450,0.0012520868113522537,0.0002959000412374735,150,11233
MMG,600,450,0.0012520868113522537,0.03481119987554848,150,11233
SoA heuristic,1000,750,0.0007507507507507507,0.0005694001447409391,250,31056
MMG,1000,750,0.0007507507507507507,0.09776640008203685,250,31056
SoA heuristic,2000,1500,0.00037518759379689845,0.001114599872380495,500,125016
MMG,2000,1500,0.00037518759379689845,0.5003896998241544,500,125016
SoA heuristic,4000,3000,0.00018754688672168043,0.056473900098353624,1000,498999
MMG,4000,3000,0.00018754688672168043,1.759737600106746,1000,498999
SoA heuristic,8000,6000,9.376172021502688e-05,0.017897900193929672,2000,2000165
MMG,8000,6000,9.376172021502688e-05,6.930537000065669,2000,2000165
SoA heuristic,20,15,0.039473684210526314,3.4300144761800766e-05,5,16
MMG,20,15,0.039473684210526314,0.00010460009798407555,5,16
SoA heuristic,40,30,0.019230769230769232,3.600004129111767e-05,10,40
MMG,40,30,0.019230769230769232,0.0002405000850558281,10,40
SoA heuristic,100,75,0.007575757575757576,6.500002928078175e-05,25,336
MMG,100,75,0.007575757575757576,0.0009896999690681696,25,336
SoA heuristic,200,150,0.0037688442211055275,0.00011999998241662979,50,1266
MMG,200,150,0.0037688442211055275,0.0034429000224918127,50,1266
SoA heuristic,400,300,0.0018796992481203006,0.00023629982024431229,100,5018
MMG,400,300,0.0018796992481203006,0.01251649996265769,100,5018
SoA heuristic,600,450,0.0012520868113522537,0.0003337000962346792,150,11271
MMG,600,450,0.0012520868113522537,0.027967500034719706,150,11271
SoA heuristic,1000,750,0.0007507507507507507,0.0006254001054912806,250,31274
MMG,1000,750,0.0007507507507507507,0.075239900033921,250,31274
SoA heuristic,2000,1500,0.00037518759379689845,0.0012991998810321093,500,124810
MMG,2000,1500,0.00037518759379689845,0.2994307999033481,500,124810
SoA heuristic,4000,3000,0.00018754688672168043,0.0027852000202983618,1000,500218
MMG,4000,3000,0.00018754688672168043,1.1251896999310702,1000,500218
SoA heuristic,8000,6000,9.376172021502688e-05,0.0057588000781834126,2000,1999995
MMG,8000,6000,9.376172021502688e-05,4.759025699924678,2000,1999995
SoA heuristic,20,15,0.039473684210526314,3.550015389919281e-05,5,14
MMG,20,15,0.039473684210526314,0.00010790000669658184,5,14
SoA heuristic,40,30,0.019230769230769232,3.3400021493434906e-05,10,58
MMG,40,30,0.019230769230769232,0.0002226000651717186,10,58
SoA heuristic,100,75,0.007575757575757576,6.960006430745125e-05,25,313
MMG,100,75,0.007575757575757576,0.0015602000057697296,25,313
SoA heuristic,200,150,0.0037688442211055275,0.000112100038677454,50,1237
MMG,200,150,0.0037688442211055275,0.003348300000652671,50,1237
SoA heuristic,400,300,0.0018796992481203006,0.00035159988328814507,100,5040
MMG,400,300,0.0018796992481203006,0.012872599996626377,100,5040
SoA heuristic,600,450,0.0012520868113522537,0.00044340011663734913,150,11391
MMG,600,450,0.0012520868113522537,0.02689269999973476,150,11391
SoA heuristic,1000,750,0.0007507507507507507,0.0006182000506669283,250,31329
MMG,1000,750,0.0007507507507507507,0.0775403999723494,250,31329
SoA heuristic,2000,1500,0.00037518759379689845,0.003350800136104226,500,124611
MMG,2000,1500,0.00037518759379689845,0.34281709999777377,500,124611
SoA heuristic,4000,3000,0.00018754688672168043,0.0029468999709933996,1000,500470
MMG,4000,3000,0.00018754688672168043,1.623274999903515,1000,500470
SoA heuristic,8000,6000,9.376172021502688e-05,0.005719800014048815,2000,2000027
MMG,8000,6000,9.376172021502688e-05,6.740312600042671,2000,2000027
SoA heuristic,20,15,0.039473684210526314,3.719981759786606e-05,5,13
MMG,20,15,0.039473684210526314,0.00012400001287460327,5,13
SoA heuristic,40,30,0.019230769230769232,3.909994848072529e-05,10,49
MMG,40,30,0.019230769230769232,0.00027900002896785736,10,49
SoA heuristic,100,75,0.007575757575757576,6.490014493465424e-05,25,315
MMG,100,75,0.007575757575757576,0.0011388999409973621,25,315
SoA heuristic,200,150,0.0037688442211055275,0.00012940005399286747,50,1239
MMG,200,150,0.0037688442211055275,0.0034388001076877117,50,1239
SoA heuristic,400,300,0.0018796992481203006,0.0004485000390559435,100,4969
MMG,400,300,0.0018796992481203006,0.013466200092807412,100,4969
SoA heuristic,600,450,0.0012520868113522537,0.0003426999319344759,150,11340
MMG,600,450,0.0012520868113522537,0.030660999938845634,150,11340
SoA heuristic,1000,750,0.0007507507507507507,0.0006703000981360674,250,31374
MMG,1000,750,0.0007507507507507507,0.0868402998894453,250,31374
SoA heuristic,2000,1500,0.00037518759379689845,0.001765799941495061,500,124971
MMG,2000,1500,0.00037518759379689845,0.35544679989106953,500,124971
SoA heuristic,4000,3000,0.00018754688672168043,0.004174399888142943,1000,500722
MMG,4000,3000,0.00018754688672168043,1.4086208997759968,1000,500722
SoA heuristic,8000,6000,9.376172021502688e-05,0.005131100071594119,2000,1999608
MMG,8000,6000,9.376172021502688e-05,5.769698600051925,2000,1999608
SoA heuristic,20,15,0.039473684210526314,3.100000321865082e-05,5,16
MMG,20,15,0.039473684210526314,0.00018569990061223507,5,16
SoA heuristic,40,30,0.019230769230769232,3.2300129532814026e-05,10,52
MMG,40,30,0.019230769230769232,0.00022000004537403584,10,52
SoA heuristic,100,75,0.007575757575757576,6.21001236140728e-05,25,315
MMG,100,75,0.007575757575757576,0.0009504000190645456,25,315
SoA heuristic,200,150,0.0037688442211055275,0.00012159999459981918,50,1203
MMG,200,150,0.0037688442211055275,0.0033098000567406416,50,1203
SoA heuristic,400,300,0.0018796992481203006,0.0002117999829351902,100,5093
MMG,400,300,0.0018796992481203006,0.011528699891641736,100,5093
SoA heuristic,600,450,0.0012520868113522537,0.00031669996678829193,150,11071
MMG,600,450,0.0012520868113522537,0.026604700135067105,150,11071
SoA heuristic,1000,750,0.0007507507507507507,0.0005838999059051275,250,31397
MMG,1000,750,0.0007507507507507507,0.08351169992238283,250,31397
SoA heuristic,2000,1500,0.00037518759379689845,0.001106400042772293,500,124966
MMG,2000,1500,0.00037518759379689845,0.3726237998344004,500,124966
SoA heuristic,4000,3000,0.00018754688672168043,0.009242699947208166,1000,499939
MMG,4000,3000,0.00018754688672168043,1.5992583001498133,1000,499939
SoA heuristic,8000,6000,9.376172021502688e-05,0.005418500164523721,2000,2001170
MMG,8000,6000,9.376172021502688e-05,6.723602900048718,2000,2001170
SoA heuristic,20,15,0.039473684210526314,3.0399998649954796e-05,5,14
MMG,20,15,0.039473684210526314,9.780004620552063e-05,5,14
SoA heuristic,40,30,0.019230769230769232,3.42000275850296e-05,10,48
MMG,40,30,0.019230769230769232,0.00023449980653822422,10,48
SoA heuristic,100,75,0.007575757575757576,7.320009171962738e-05,25,323
MMG,100,75,0.007575757575757576,0.0013939999043941498,25,323
SoA heuristic,200,150,0.0037688442211055275,0.0001083998940885067,50,1293
MMG,200,150,0.0037688442211055275,0.00336650013923645,50,1293
SoA heuristic,400,300,0.0018796992481203006,0.00020440015941858292,100,5047
MMG,400,300,0.0018796992481203006,0.014664300018921494,100,5047
SoA heuristic,600,450,0.0012520868113522537,0.0008372000884264708,150,11237
MMG,600,450,0.0012520868113522537,0.04320660000666976,150,11237
SoA heuristic,1000,750,0.0007507507507507507,0.0005643998738378286,250,30976
MMG,1000,750,0.0007507507507507507,0.11719859996810555,250,30976
SoA heuristic,2000,1500,0.00037518759379689845,0.0011141998693346977,500,125103
MMG,2000,1500,0.00037518759379689845,0.41319709992967546,500,125103
SoA heuristic,4000,3000,0.00018754688672168043,0.003163000103086233,1000,499885
MMG,4000,3000,0.00018754688672168043,1.6853693998418748,1000,499885
SoA heuristic,8000,6000,9.376172021502688e-05,0.008825300028547645,2000,1998593
MMG,8000,6000,9.376172021502688e-05,7.287498400080949,2000,1998593
SoA heuristic,20,15,0.039473684210526314,2.9300106689333916e-05,5,15
MMG,20,15,0.039473684210526314,9.400001727044582e-05,5,15
SoA heuristic,40,30,0.019230769230769232,4.0599843487143517e-05,10,54
MMG,40,30,0.019230769230769232,0.00022320006974041462,10,54
SoA heuristic,100,75,0.007575757575757576,5.689985118806362e-05,25,311
MMG,100,75,0.007575757575757576,0.002329000039026141,25,311
SoA heuristic,200,150,0.0037688442211055275,0.00013699987903237343,50,1264
MMG,200,150,0.0037688442211055275,0.004264799878001213,50,1264
SoA heuristic,400,300,0.0018796992481203006,0.0002088998444378376,100,4957
MMG,400,300,0.0018796992481203006,0.011634299997240305,100,4957
SoA heuristic,600,450,0.0012520868113522537,0.0003125998191535473,150,11279
MMG,600,450,0.0012520868113522537,0.036555300001055,150,11279
SoA heuristic,1000,750,0.0007507507507507507,0.0005570999346673489,250,31365
MMG,1000,750,0.0007507507507507507,0.08528049988672137,250,31365
SoA heuristic,2000,1500,0.00037518759379689845,0.0016252000350505114,500,124825
MMG,2000,1500,0.00037518759379689845,0.4051640999969095,500,124825
SoA heuristic,4000,3000,0.00018754688672168043,0.002705699997022748,1000,499344
MMG,4000,3000,0.00018754688672168043,1.7245310000143945,1000,499344
SoA heuristic,8000,6000,9.376172021502688e-05,0.00536189996637404,2000,1999417
MMG,8000,6000,9.376172021502688e-05,6.903853500029072,2000,1999417
SoA heuristic,20,15,0.039473684210526314,7.500010542571545e-05,5,9
MMG,20,15,0.039473684210526314,0.0002943000290542841,5,9
SoA heuristic,40,30,0.019230769230769232,8.17000400274992e-05,10,48
MMG,40,30,0.019230769230769232,0.0005807999987155199,10,48
SoA heuristic,100,75,0.007575757575757576,0.00015529990196228027,25,317
MMG,100,75,0.007575757575757576,0.0016723000444471836,25,317
SoA heuristic,200,150,0.0037688442211055275,0.00011990009807050228,50,1244
MMG,200,150,0.0037688442211055275,0.0030360999517142773,50,1244
SoA heuristic,400,300,0.0018796992481203006,0.0003066000062972307,100,5025
MMG,400,300,0.0018796992481203006,0.02260609995573759,100,5025
SoA heuristic,600,450,0.0012520868113522537,0.0011930998880416155,150,11159
MMG,600,450,0.0012520868113522537,0.054829200031235814,150,11159
SoA heuristic,1000,750,0.0007507507507507507,0.0008662000764161348,250,31160
MMG,1000,750,0.0007507507507507507,0.12145680002868176,250,31160
SoA heuristic,2000,1500,0.00037518759379689845,0.0020010999869555235,500,125368
MMG,2000,1500,0.00037518759379689845,0.38961010007187724,500,125368
SoA heuristic,4000,3000,0.00018754688672168043,0.006695300107821822,1000,499268
MMG,4000,3000,0.00018754688672168043,1.6690395998302847,1000,499268
SoA heuristic,8000,6000,9.376172021502688e-05,0.010512500070035458,2000,2001549
MMG,8000,6000,9.376172021502688e-05,7.513830200070515,2000,2001549
SoA heuristic,20,15,0.039473684210526314,6.420002318918705e-05,5,6
MMG,20,15,0.039473684210526314,0.00025899987667798996,5,6
SoA heuristic,40,30,0.019230769230769232,3.239978104829788e-05,10,52
MMG,40,30,0.019230769230769232,0.0002880999818444252,10,52
SoA heuristic,100,75,0.007575757575757576,0.00017799995839595795,25,331
MMG,100,75,0.007575757575757576,0.0008852998726069927,25,331
SoA heuristic,200,150,0.0037688442211055275,0.00010040006600320339,50,1274
MMG,200,150,0.0037688442211055275,0.0029768000822514296,50,1274
SoA heuristic,400,300,0.0018796992481203006,0.0001922000665217638,100,4996
MMG,400,300,0.0018796992481203006,0.011121799936518073,100,4996
SoA heuristic,600,450,0.0012520868113522537,0.0008225999772548676,150,11329
MMG,600,450,0.0012520868113522537,0.03193280007690191,150,11329
SoA heuristic,1000,750,0.0007507507507507507,0.0005487001035362482,250,31225
MMG,1000,750,0.0007507507507507507,0.13780489983037114,250,31225
SoA heuristic,2000,1500,0.00037518759379689845,0.0012733000330626965,500,125348
MMG,2000,1500,0.00037518759379689845,0.38336659991182387,500,125348
SoA heuristic,4000,3000,0.00018754688672168043,0.003913599997758865,1000,500236
MMG,4000,3000,0.00018754688672168043,1.8933143999893218,1000,500236
SoA heuristic,8000,6000,9.376172021502688e-05,0.04987119999714196,2000,1998561
MMG,8000,6000,9.376172021502688e-05,7.714579200139269,2000,1998561
SoA heuristic,20,15,0.039473684210526314,7.71000050008297e-05,5,13
MMG,20,15,0.039473684210526314,0.0003003000747412443,5,13
SoA heuristic,40,30,0.019230769230769232,3.260001540184021e-05,10,44
MMG,40,30,0.019230769230769232,0.00021469988860189915,10,44
SoA heuristic,100,75,0.007575757575757576,5.9399986639618874e-05,25,317
MMG,100,75,0.007575757575757576,0.0008925001602619886,25,317
SoA heuristic,200,150,0.0037688442211055275,0.00010519986972212791,50,1234
MMG,200,150,0.0037688442211055275,0.002993199974298477,50,1234
SoA heuristic,400,300,0.0018796992481203006,0.0001946999691426754,100,5054
MMG,400,300,0.0018796992481203006,0.01992040011100471,100,5054
SoA heuristic,600,450,0.0012520868113522537,0.0008908999152481556,150,11120
MMG,600,450,0.0012520868113522537,0.035471699899062514,150,11120
SoA heuristic,1000,750,0.0007507507507507507,0.0016585001721978188,250,31108
MMG,1000,750,0.0007507507507507507,0.12656710017472506,250,31108
SoA heuristic,2000,1500,0.00037518759379689845,0.0011193999089300632,500,124995
MMG,2000,1500,0.00037518759379689845,0.46217840001918375,500,124995
SoA heuristic,4000,3000,0.00018754688672168043,0.005345600191503763,1000,498912
MMG,4000,3000,0.00018754688672168043,1.7472551001701504,1000,498912
SoA heuristic,8000,6000,9.376172021502688e-05,0.004686000058427453,2000,1999894
MMG,8000,6000,9.376172021502688e-05,7.05193980014883,2000,1999894
SoA heuristic,20,15,0.039473684210526314,4.940014332532883e-05,5,14
MMG,20,15,0.039473684210526314,0.00018770014867186546,5,14
SoA heuristic,40,30,0.019230769230769232,5.7300087064504623e-05,10,51
MMG,40,30,0.019230769230769232,0.0004423998761922121,10,51
SoA heuristic,100,75,0.007575757575757576,0.00011539994738996029,25,315
MMG,100,75,0.007575757575757576,0.0014690000098198652,25,315
SoA heuristic,200,150,0.0037688442211055275,0.00019119982607662678,50,1236
MMG,200,150,0.0037688442211055275,0.0034572998993098736,50,1236
SoA heuristic,400,300,0.0018796992481203006,0.0001922999508678913,100,5015
MMG,400,300,0.0018796992481203006,0.011165200034156442,100,5015
SoA heuristic,600,450,0.0012520868113522537,0.00029399991035461426,150,11201
MMG,600,450,0.0012520868113522537,0.052462000166997313,150,11201
SoA heuristic,1000,750,0.0007507507507507507,0.0016324999742209911,250,31259
MMG,1000,750,0.0007507507507507507,0.11865950003266335,250,31259
SoA heuristic,2000,1500,0.00037518759379689845,0.0011158999986946583,500,124417
MMG,2000,1500,0.00037518759379689845,0.4276998999994248,500,124417
SoA heuristic,4000,3000,0.00018754688672168043,0.00224210019223392,1000,500020
MMG,4000,3000,0.00018754688672168043,1.567445700056851,1000,500020
SoA heuristic,8000,6000,9.376172021502688e-05,0.005489900009706616,2000,1999164
MMG,8000,6000,9.376172021502688e-05,7.2664861001539975,2000,1999164
SoA heuristic,20,15,0.039473684210526314,2.859998494386673e-05,5,14
MMG,20,15,0.039473684210526314,9.330012835562229e-05,5,14
SoA heuristic,40,30,0.019230769230769232,3.190012648701668e-05,10,56
MMG,40,30,0.019230769230769232,0.00020999996922910213,10,56
SoA heuristic,100,75,0.007575757575757576,5.75000885874033e-05,25,312
MMG,100,75,0.007575757575757576,0.0008966000750660896,25,312
SoA heuristic,200,150,0.0037688442211055275,0.00010460009798407555,50,1277
MMG,200,150,0.0037688442211055275,0.0030487000476568937,50,1277
SoA heuristic,400,300,0.0018796992481203006,0.0005978001281619072,100,5096
MMG,400,300,0.0018796992481203006,0.01603199983946979,100,5096
SoA heuristic,600,450,0.0012520868113522537,0.0008728001266717911,150,11321
MMG,600,450,0.0012520868113522537,0.05341670010238886,150,11321
SoA heuristic,1000,750,0.0007507507507507507,0.0015569000970572233,250,31280
MMG,1000,750,0.0007507507507507507,0.11134770000353456,250,31280
SoA heuristic,2000,1500,0.00037518759379689845,0.0026299001183360815,500,124826
MMG,2000,1500,0.00037518759379689845,0.3653366998769343,500,124826
SoA heuristic,4000,3000,0.00018754688672168043,0.0022189998999238014,1000,500175
MMG,4000,3000,0.00018754688672168043,1.7930140998214483,1000,500175
SoA heuristic,8000,6000,9.376172021502688e-05,0.008055000100284815,2000,2000286
MMG,8000,6000,9.376172021502688e-05,7.081388499820605,2000,2000286
SoA heuristic,20,15,0.039473684210526314,3.0800001695752144e-05,5,12
MMG,20,15,0.039473684210526314,0.00010140007361769676,5,12
SoA heuristic,40,30,0.019230769230769232,7.790001109242439e-05,10,53
MMG,40,30,0.019230769230769232,0.00021409988403320312,10,53
SoA heuristic,100,75,0.007575757575757576,5.7499855756759644e-05,25,290
MMG,100,75,0.007575757575757576,0.0021377000957727432,25,290
SoA heuristic,200,150,0.0037688442211055275,0.0002788999117910862,50,1245
MMG,200,150,0.0037688442211055275,0.008724200073629618,50,1245
SoA heuristic,400,300,0.0018796992481203006,0.00038579991087317467,100,5027
MMG,400,300,0.0018796992481203006,0.025060700019821525,100,5027
SoA heuristic,600,450,0.0012520868113522537,0.0008137000259011984,150,11310
MMG,600,450,0.0012520868113522537,0.02664019982330501,150,11310
SoA heuristic,1000,750,0.0007507507507507507,0.000560099957510829,250,31285
MMG,1000,750,0.0007507507507507507,0.14472310012206435,250,31285
SoA heuristic,2000,1500,0.00037518759379689845,0.001075000036507845,500,125030
MMG,2000,1500,0.00037518759379689845,0.49238840001635253,500,125030
SoA heuristic,4000,3000,0.00018754688672168043,0.003275900147855282,1000,499786
MMG,4000,3000,0.00018754688672168043,1.7311991997994483,1000,499786
SoA heuristic,8000,6000,9.376172021502688e-05,0.005292200017720461,2000,2001444
MMG,8000,6000,9.376172021502688e-05,6.80879530007951,2000,2001444
SoA heuristic,20,15,0.039473684210526314,2.8199981898069382e-05,5,9
MMG,20,15,0.039473684210526314,9.320001117885113e-05,5,9
SoA heuristic,40,30,0.019230769230769232,3.1400006264448166e-05,10,62
MMG,40,30,0.019230769230769232,0.0002133999951183796,10,62
SoA heuristic,100,75,0.007575757575757576,5.579995922744274e-05,25,323
MMG,100,75,0.007575757575757576,0.0008827000856399536,25,323
SoA heuristic,200,150,0.0037688442211055275,0.00010360009036958218,50,1274
MMG,200,150,0.0037688442211055275,0.004932499956339598,50,1274
SoA heuristic,400,300,0.0018796992481203006,0.0005682001356035471,100,4909
MMG,400,300,0.0018796992481203006,0.022662099916487932,100,4909
SoA heuristic,600,450,0.0012520868113522537,0.0003115998115390539,150,11220
MMG,600,450,0.0012520868113522537,0.04195660003460944,150,11220
SoA heuristic,1000,750,0.0007507507507507507,0.001735299825668335,250,31243
MMG,1000,750,0.0007507507507507507,0.10549809993244708,250,31243
SoA heuristic,2000,1500,0.00037518759379689845,0.0014100999105721712,500,124626
MMG,2000,1500,0.00037518759379689845,0.4707341999746859,500,124626
SoA heuristic,4000,3000,0.00018754688672168043,0.002304699970409274,1000,499652
MMG,4000,3000,0.00018754688672168043,1.6959532001055777,1000,499652
SoA heuristic,8000,6000,9.376172021502688e-05,0.005240599857643247,2000,2000698
MMG,8000,6000,9.376172021502688e-05,7.332128399983048,2000,2000698
SoA heuristic,20,15,0.039473684210526314,2.8799986466765404e-05,5,15
MMG,20,15,0.039473684210526314,9.350012987852097e-05,5,15
SoA heuristic,40,30,0.019230769230769232,9.360001422464848e-05,10,48
MMG,40,30,0.019230769230769232,0.0006689999718219042,10,48
SoA heuristic,100,75,0.007575757575757576,0.00017449981532990932,25,305
MMG,100,75,0.007575757575757576,0.0027106001507490873,25,305
SoA heuristic,200,150,0.0037688442211055275,0.0003141001798212528,50,1310
MMG,200,150,0.0037688442211055275,0.009255599929019809,50,1310
SoA heuristic,400,300,0.0018796992481203006,0.0006228999700397253,100,5049
MMG,400,300,0.0018796992481203006,0.018063999945297837,100,5049
SoA heuristic,600,450,0.0012520868113522537,0.0008415998890995979,150,11073
MMG,600,450,0.0012520868113522537,0.0661597999278456,150,11073
SoA heuristic,1000,750,0.0007507507507507507,0.0015685001853853464,250,31265
MMG,1000,750,0.0007507507507507507,0.1127105001360178,250,31265
SoA heuristic,2000,1500,0.00037518759379689845,0.0011009001173079014,500,125101
MMG,2000,1500,0.00037518759379689845,0.4101166999898851,500,125101
SoA heuristic,4000,3000,0.00018754688672168043,0.002798000117763877,1000,499449
MMG,4000,3000,0.00018754688672168043,1.9414045000448823,1000,499449
SoA heuristic,8000,6000,9.376172021502688e-05,0.014320499962195754,2000,2000178
MMG,8000,6000,9.376172021502688e-05,6.8585239998064935,2000,2000178
SoA heuristic,20,15,0.039473684210526314,3.0100112780928612e-05,5,13
MMG,20,15,0.039473684210526314,9.50000248849392e-05,5,13
SoA heuristic,40,30,0.019230769230769232,3.329990431666374e-05,10,56
MMG,40,30,0.019230769230769232,0.00022529996931552887,10,56
SoA heuristic,100,75,0.007575757575757576,5.8099860325455666e-05,25,312
MMG,100,75,0.007575757575757576,0.0008987998589873314,25,312
SoA heuristic,200,150,0.0037688442211055275,0.00010240008123219013,50,1219
MMG,200,150,0.0037688442211055275,0.003255800111219287,50,1219
SoA heuristic,400,300,0.0018796992481203006,0.00019970000721514225,100,5039
MMG,400,300,0.0018796992481203006,0.011276199948042631,100,5039
SoA heuristic,600,450,0.0012520868113522537,0.0008845000993460417,150,11382
MMG,600,450,0.0012520868113522537,0.06279690004885197,150,11382
SoA heuristic,1000,750,0.0007507507507507507,0.001776800025254488,250,31353
MMG,1000,750,0.0007507507507507507,0.154924200149253,250,31353
SoA heuristic,2000,1500,0.00037518759379689845,0.0011370000429451466,500,125610
MMG,2000,1500,0.00037518759379689845,0.44258170016109943,500,125610
SoA heuristic,4000,3000,0.00018754688672168043,0.002208600053563714,1000,499758
MMG,4000,3000,0.00018754688672168043,1.6956436999607831,1000,499758
SoA heuristic,8000,6000,9.376172021502688e-05,0.013817199971526861,2000,1999848
MMG,8000,6000,9.376172021502688e-05,6.780236599966884,2000,1999848
SoA heuristic,20,15,0.039473684210526314,6.949994713068008e-05,5,14
MMG,20,15,0.039473684210526314,0.0002639999147504568,5,14
SoA heuristic,40,30,0.019230769230769232,3.169989213347435e-05,10,52
MMG,40,30,0.019230769230769232,0.00021779979579150677,10,52
SoA heuristic,100,75,0.007575757575757576,6.270012818276882e-05,25,309
MMG,100,75,0.007575757575757576,0.0008762001525610685,25,309
SoA heuristic,200,150,0.0037688442211055275,0.0002894999925047159,50,1282
MMG,200,150,0.0037688442211055275,0.006144799990579486,50,1282
SoA heuristic,400,300,0.0018796992481203006,0.0003208001144230366,100,4972
MMG,400,300,0.0018796992481203006,0.019320599967613816,100,4972
SoA heuristic,600,450,0.0012520868113522537,0.0006056998390704393,150,11198
MMG,600,450,0.0012520868113522537,0.029673099983483553,150,11198
SoA heuristic,1000,750,0.0007507507507507507,0.0019383998587727547,250,31325
MMG,1000,750,0.0007507507507507507,0.0993085999507457,250,31325
SoA heuristic,2000,1500,0.00037518759379689845,0.0013123000971972942,500,124692
MMG,2000,1500,0.00037518759379689845,0.48748279991559684,500,124692
SoA heuristic,4000,3000,0.00018754688672168043,0.003666900098323822,1000,500858
MMG,4000,3000,0.00018754688672168043,1.776710500009358,1000,500858
SoA heuristic,8000,6000,9.376172021502688e-05,0.056289799977093935,2000,1999297
MMG,8000,6000,9.376172021502688e-05,7.333507499890402,2000,1999297
SoA heuristic,20,15,0.039473684210526314,4.9900030717253685e-05,5,9
MMG,20,15,0.039473684210526314,0.00022179982624948025,5,9
SoA heuristic,40,30,0.019230769230769232,7.16999638825655e-05,10,48
MMG,40,30,0.019230769230769232,0.0005695000290870667,10,48
SoA heuristic,100,75,0.007575757575757576,9.310012683272362e-05,25,322
MMG,100,75,0.007575757575757576,0.0015638999175280333,25,322
SoA heuristic,200,150,0.0037688442211055275,0.0001558999065309763,50,1203
MMG,200,150,0.0037688442211055275,0.0052535999566316605,50,1203
SoA heuristic,400,300,0.0018796992481203006,0.00019789999350905418,100,5005
MMG,400,300,0.0018796992481203006,0.01125849992968142,100,5005
SoA heuristic,600,450,0.0012520868113522537,0.00029259989969432354,150,11385
MMG,600,450,0.0012520868113522537,0.026948600076138973,150,11385
SoA heuristic,1000,750,0.0007507507507507507,0.0006313000340014696,250,31379
MMG,1000,750,0.0007507507507507507,0.0937493999954313,250,31379
SoA heuristic,2000,1500,0.00037518759379689845,0.001212199917063117,500,124859
MMG,2000,1500,0.00037518759379689845,0.32542789983563125,500,124859
SoA heuristic,4000,3000,0.00018754688672168043,0.0022058000322431326,1000,499923
MMG,4000,3000,0.00018754688672168043,1.9319011999759823,1000,499923
SoA heuristic,8000,6000,9.376172021502688e-05,0.005392100196331739,2000,1999961
MMG,8000,6000,9.376172021502688e-05,7.517688499996439,2000,1999961
SoA heuristic,20,15,0.039473684210526314,2.7799978852272034e-05,5,10
MMG,20,15,0.039473684210526314,9.950017556548119e-05,5,10
SoA heuristic,40,30,0.019230769230769232,3.390014171600342e-05,10,51
MMG,40,30,0.019230769230769232,0.00021239998750388622,10,51
SoA heuristic,100,75,0.007575757575757576,5.570007488131523e-05,25,311
MMG,100,75,0.007575757575757576,0.0008843999821692705,25,311
SoA heuristic,200,150,0.0037688442211055275,0.00010119983926415443,50,1242
MMG,200,150,0.0037688442211055275,0.0030413998756557703,50,1242
SoA heuristic,400,300,0.0018796992481203006,0.0002194000408053398,100,4976
MMG,400,300,0.0018796992481203006,0.02072749985381961,100,4976
SoA heuristic,600,450,0.0012520868113522537,0.000879199942573905,150,11201
MMG,600,450,0.0012520868113522537,0.04811819992028177,150,11201
SoA heuristic,1000,750,0.0007507507507507507,0.001608600141480565,250,31150
MMG,1000,750,0.0007507507507507507,0.14855260006152093,250,31150
SoA heuristic,2000,1500,0.00037518759379689845,0.0033680000342428684,500,125092
MMG,2000,1500,0.00037518759379689845,0.4869679999537766,500,125092
SoA heuristic,4000,3000,0.00018754688672168043,0.0021460000425577164,1000,499042
MMG,4000,3000,0.00018754688672168043,1.821463800035417,1000,499042
SoA heuristic,8000,6000,9.376172021502688e-05,0.012264299904927611,2000,1998855
MMG,8000,6000,9.376172021502688e-05,7.265749100130051,2000,1998855
SoA heuristic,20,15,0.039473684210526314,6.160000339150429e-05,5,13
MMG,20,15,0.039473684210526314,0.0002568999771028757,5,13
SoA heuristic,40,30,0.019230769230769232,3.0300114303827286e-05,10,37
MMG,40,30,0.019230769230769232,0.00021249987185001373,10,37
SoA heuristic,100,75,0.007575757575757576,0.00017190002836287022,25,330
MMG,100,75,0.007575757575757576,0.0028333000373095274,25,330
SoA heuristic,200,150,0.0037688442211055275,0.00021270010620355606,50,1234
MMG,200,150,0.0037688442211055275,0.005029199877753854,50,1234
SoA heuristic,400,300,0.0018796992481203006,0.00019129994325339794,100,4978
MMG,400,300,0.0018796992481203006,0.028704300057142973,100,4978
SoA heuristic,600,450,0.0012520868113522537,0.00043489993549883366,150,11280
MMG,600,450,0.0012520868113522537,0.03873599995858967,150,11280
SoA heuristic,1000,750,0.0007507507507507507,0.0013124998658895493,250,31109
MMG,1000,750,0.0007507507507507507,0.12523040012456477,250,31109
SoA heuristic,2000,1500,0.00037518759379689845,0.0022770999930799007,500,124903
MMG,2000,1500,0.00037518759379689845,0.4798244000412524,500,124903
SoA heuristic,4000,3000,0.00018754688672168043,0.0027336999773979187,1000,499106
MMG,4000,3000,0.00018754688672168043,2.074823700124398,1000,499106
SoA heuristic,8000,6000,9.376172021502688e-05,0.006122400052845478,2000,1999301
MMG,8000,6000,9.376172021502688e-05,7.4941747998818755,2000,1999301
SoA heuristic,20,15,0.039473684210526314,6.869994103908539e-05,5,14
MMG,20,15,0.039473684210526314,0.00029959995299577713,5,14
SoA heuristic,40,30,0.019230769230769232,4.169996827840805e-05,10,51
MMG,40,30,0.019230769230769232,0.00021249987185001373,10,51
SoA heuristic,100,75,0.007575757575757576,5.810009315609932e-05,25,315
MMG,100,75,0.007575757575757576,0.001451499992981553,25,315
SoA heuristic,200,150,0.0037688442211055275,0.00010569998994469643,50,1232
MMG,200,150,0.0037688442211055275,0.002988399937748909,50,1232
SoA heuristic,400,300,0.0018796992481203006,0.00019529997371137142,100,5010
MMG,400,300,0.0018796992481203006,0.011780200060456991,100,5010
SoA heuristic,600,450,0.0012520868113522537,0.0002827998250722885,150,11331
MMG,600,450,0.0012520868113522537,0.032546000089496374,150,11331
SoA heuristic,1000,750,0.0007507507507507507,0.0005563001614063978,250,31238
MMG,1000,750,0.0007507507507507507,0.12950439983978868,250,31238
SoA heuristic,2000,1500,0.00037518759379689845,0.0011469998862594366,500,124847
MMG,2000,1500,0.00037518759379689845,0.5720074998680502,500,124847
SoA heuristic,4000,3000,0.00018754688672168043,0.002763699973002076,1000,499950
MMG,4000,3000,0.00018754688672168043,1.9571908998768777,1000,499950
SoA heuristic,8000,6000,9.376172021502688e-05,0.010605300078168511,2000,1996286
MMG,8000,6000,9.376172021502688e-05,7.138773299986497,2000,1996286
SoA heuristic,20,15,0.039473684210526314,2.8999987989664078e-05,5,14
MMG,20,15,0.039473684210526314,9.099999442696571e-05,5,14
SoA heuristic,40,30,0.019230769230769232,3.3899908885359764e-05,10,53
MMG,40,30,0.019230769230769232,0.0003276001662015915,10,53
SoA heuristic,100,75,0.007575757575757576,5.619996227324009e-05,25,324
MMG,100,75,0.007575757575757576,0.0008950000628829002,25,324
SoA heuristic,200,150,0.0037688442211055275,0.0001020999625325203,50,1283
MMG,200,150,0.0037688442211055275,0.003034000052139163,50,1283
SoA heuristic,400,300,0.0018796992481203006,0.00019369996152818203,100,5010
MMG,400,300,0.0018796992481203006,0.01353310002014041,100,5010
SoA heuristic,600,450,0.0012520868113522537,0.0003029000945389271,150,11352
MMG,600,450,0.0012520868113522537,0.03649579989723861,150,11352
SoA heuristic,1000,750,0.0007507507507507507,0.0005542999133467674,250,31309
MMG,1000,750,0.0007507507507507507,0.1293301999103278,250,31309
SoA heuristic,2000,1500,0.00037518759379689845,0.0012870999053120613,500,125025
MMG,2000,1500,0.00037518759379689845,0.4620288999285549,500,125025
SoA heuristic,4000,3000,0.00018754688672168043,0.0022484001237899065,1000,500519
MMG,4000,3000,0.00018754688672168043,1.7821984998881817,1000,500519
SoA heuristic,8000,6000,9.376172021502688e-05,0.007743700174614787,2000,2000389
MMG,8000,6000,9.376172021502688e-05,7.444235499948263,2000,2000389
SoA heuristic,20,15,0.039473684210526314,5.0999922677874565e-05,5,15
MMG,20,15,0.039473684210526314,0.00017949985340237617,5,15
SoA heuristic,40,30,0.019230769230769232,8.450006134808064e-05,10,64
MMG,40,30,0.019230769230769232,0.0006426998879760504,10,64
SoA heuristic,100,75,0.007575757575757576,0.00015860004350543022,25,325
MMG,100,75,0.007575757575757576,0.0026197999250143766,25,325
SoA heuristic,200,150,0.0037688442211055275,0.00030269986018538475,50,1241
MMG,200,150,0.0037688442211055275,0.007072600070387125,50,1241
SoA heuristic,400,300,0.0018796992481203006,0.0005469999741762877,100,5123
MMG,400,300,0.0018796992481203006,0.01618509995751083,100,5123
SoA heuristic,600,450,0.0012520868113522537,0.0008538002148270607,150,11292
MMG,600,450,0.0012520868113522537,0.05980410007759929,150,11292
SoA heuristic,1000,750,0.0007507507507507507,0.0014818999916315079,250,31039
MMG,1000,750,0.0007507507507507507,0.1365704000927508,250,31039
SoA heuristic,2000,1500,0.00037518759379689845,0.0018106000497937202,500,125084
MMG,2000,1500,0.00037518759379689845,0.4404635999817401,500,125084
SoA heuristic,4000,3000,0.00018754688672168043,0.002442099852487445,1000,499275
MMG,4000,3000,0.00018754688672168043,1.8561086999252439,1000,499275
SoA heuristic,8000,6000,9.376172021502688e-05,0.005301600089296699,2000,2000022
MMG,8000,6000,9.376172021502688e-05,7.6411633000243455,2000,2000022
SoA heuristic,20,15,0.039473684210526314,2.769986167550087e-05,5,10
MMG,20,15,0.039473684210526314,9.20998863875866e-05,5,10
SoA heuristic,40,30,0.019230769230769232,3.200001083314419e-05,10,45
MMG,40,30,0.019230769230769232,0.00021199998445808887,10,45
SoA heuristic,100,75,0.007575757575757576,5.719996988773346e-05,25,326
MMG,100,75,0.007575757575757576,0.0009678001515567303,25,326
SoA heuristic,200,150,0.0037688442211055275,0.00010189996100962162,50,1254
MMG,200,150,0.0037688442211055275,0.003032999811694026,50,1254
SoA heuristic,400,300,0.0018796992481203006,0.00019740010611712933,100,4940
MMG,400,300,0.0018796992481203006,0.03159380005672574,100,4940
SoA heuristic,600,450,0.0012520868113522537,0.0009082001633942127,150,11308
MMG,600,450,0.0012520868113522537,0.061466800048947334,150,11308
SoA heuristic,1000,750,0.0007507507507507507,0.0005171999800950289,250,31103
MMG,1000,750,0.0007507507507507507,0.12798930006101727,250,31103
SoA heuristic,2000,1500,0.00037518759379689845,0.0011880001984536648,500,124642
MMG,2000,1500,0.00037518759379689845,0.5023283998016268,500,124642
SoA heuristic,4000,3000,0.00018754688672168043,0.002275200095027685,1000,499686
MMG,4000,3000,0.00018754688672168043,1.9851844999939203,1000,499686
SoA heuristic,8000,6000,9.376172021502688e-05,0.008571600075811148,2000,2000214
MMG,8000,6000,9.376172021502688e-05,7.661693499889225,2000,2000214
SoA heuristic,20,15,0.039473684210526314,8.040014654397964e-05,5,9
MMG,20,15,0.039473684210526314,0.0003400000277906656,5,9
SoA heuristic,40,30,0.019230769230769232,0.0001379998866468668,10,47
MMG,40,30,0.019230769230769232,0.00076299998909235,10,47
SoA heuristic,100,75,0.007575757575757576,0.00018790015019476414,25,324
MMG,100,75,0.007575757575757576,0.002897400176152587,25,324
SoA heuristic,200,150,0.0037688442211055275,0.00010289996862411499,50,1224
MMG,200,150,0.0037688442211055275,0.007221199804916978,50,1224
SoA heuristic,400,300,0.0018796992481203006,0.0004118001088500023,100,4965
MMG,400,300,0.0018796992481203006,0.0202096002176404,100,4965
SoA heuristic,600,450,0.0012520868113522537,0.000555599806830287,150,11131
MMG,600,450,0.0012520868113522537,0.04711239994503558,150,11131
SoA heuristic,1000,750,0.0007507507507507507,0.0005344999954104424,250,31323
MMG,1000,750,0.0007507507507507507,0.1442951001226902,250,31323
SoA heuristic,2000,1500,0.00037518759379689845,0.0038240000139921904,500,124974
MMG,2000,1500,0.00037518759379689845,0.4613635998684913,500,124974
SoA heuristic,4000,3000,0.00018754688672168043,0.002187300007790327,1000,499695
MMG,4000,3000,0.00018754688672168043,1.8289725999347866,1000,499695
SoA heuristic,8000,6000,9.376172021502688e-05,0.05538169993087649,2000,1998342
MMG,8000,6000,9.376172021502688e-05,7.2206562999635935,2000,1998342
SoA heuristic,20,15,0.039473684210526314,7.700012065470219e-05,5,12
MMG,20,15,0.039473684210526314,0.00026899995282292366,5,12
SoA heuristic,40,30,0.019230769230769232,7.30000901967287e-05,10,44
MMG,40,30,0.019230769230769232,0.0005278999451547861,10,44
SoA heuristic,100,75,0.007575757575757576,0.00012179999612271786,25,294
MMG,100,75,0.007575757575757576,0.0013973000459372997,25,294
SoA heuristic,200,150,0.0037688442211055275,0.00013489997945725918,50,1210
MMG,200,150,0.0037688442211055275,0.003033299930393696,50,1210
SoA heuristic,400,300,0.0018796992481203006,0.00019800011068582535,100,4986
MMG,400,300,0.0018796992481203006,0.010979499900713563,100,4986
SoA heuristic,600,450,0.0012520868113522537,0.000826600007712841,150,11253
MMG,600,450,0.0012520868113522537,0.031976799946278334,150,11253
SoA heuristic,1000,750,0.0007507507507507507,0.001528399996459484,250,31121
MMG,1000,750,0.0007507507507507507,0.12199670006521046,250,31121
SoA heuristic,2000,1500,0.00037518759379689845,0.0010967000853270292,500,125075
MMG,2000,1500,0.00037518759379689845,0.4948502001352608,500,125075
SoA heuristic,4000,3000,0.00018754688672168043,0.002695700153708458,1000,500608
MMG,4000,3000,0.00018754688672168043,1.9655577999074012,1000,500608
SoA heuristic,8000,6000,9.376172021502688e-05,0.010506700025871396,2000,1998646
MMG,8000,6000,9.376172021502688e-05,7.060938199982047,2000,1998646
SoA heuristic,20,15,0.039473684210526314,2.9099872335791588e-05,5,12
MMG,20,15,0.039473684210526314,9.119999594986439e-05,5,12
SoA heuristic,40,30,0.019230769230769232,3.0199997127056122e-05,10,57
MMG,40,30,0.019230769230769232,0.0002142998855561018,10,57
SoA heuristic,100,75,0.007575757575757576,5.8399979025125504e-05,25,310
MMG,100,75,0.007575757575757576,0.0009113999549299479,25,310
SoA heuristic,200,150,0.0037688442211055275,0.0001034000888466835,50,1264
MMG,200,150,0.0037688442211055275,0.0036742999218404293,50,1264
SoA heuristic,400,300,0.0018796992481203006,0.00023459992371499538,100,5077
MMG,400,300,0.0018796992481203006,0.012392800068482757,100,5077
SoA heuristic,600,450,0.0012520868113522537,0.0002929000183939934,150,11309
MMG,600,450,0.0012520868113522537,0.05470039998181164,150,11309
SoA heuristic,1000,750,0.0007507507507507507,0.0008821000810712576,250,31551
MMG,1000,750,0.0007507507507507507,0.14495370001532137,250,31551
SoA heuristic,2000,1500,0.00037518759379689845,0.0027538000140339136,500,125187
MMG,2000,1500,0.00037518759379689845,0.45982360001653433,500,125187
SoA heuristic,4000,3000,0.00018754688672168043,0.0024512000381946564,1000,501093
MMG,4000,3000,0.00018754688672168043,1.9171939000952989,1000,501093
SoA heuristic,8000,6000,9.376172021502688e-05,0.01153869996778667,2000,2000874
MMG,8000,6000,9.376172021502688e-05,7.05545790004544,2000,2000874
SoA heuristic,20,15,0.039473684210526314,3.0800001695752144e-05,5,8
MMG,20,15,0.039473684210526314,0.00011319993063807487,5,8
SoA heuristic,40,30,0.019230769230769232,3.220001235604286e-05,10,49
MMG,40,30,0.019230769230769232,0.0002125999890267849,10,49
SoA heuristic,100,75,0.007575757575757576,5.8099860325455666e-05,25,340
MMG,100,75,0.007575757575757576,0.0027574000414460897,25,340
SoA heuristic,200,150,0.0037688442211055275,0.000341000035405159,50,1231
MMG,200,150,0.0037688442211055275,0.006762500153854489,50,1231
SoA heuristic,400,300,0.0018796992481203006,0.0002905000001192093,100,4986
MMG,400,300,0.0018796992481203006,0.02269349992275238,100,4986
SoA heuristic,600,450,0.0012520868113522537,0.00033989991061389446,150,11203
MMG,600,450,0.0012520868113522537,0.02498880005441606,150,11203
SoA heuristic,1000,750,0.0007507507507507507,0.0011076999362558126,250,31105
MMG,1000,750,0.0007507507507507507,0.0838073999620974,250,31105
SoA heuristic,2000,1500,0.00037518759379689845,0.0010725001338869333,500,125048
MMG,2000,1500,0.00037518759379689845,0.44352190010249615,500,125048
SoA heuristic,4000,3000,0.00018754688672168043,0.006645099958404899,1000,499691
MMG,4000,3000,0.00018754688672168043,1.9100003000348806,1000,499691
SoA heuristic,8000,6000,9.376172021502688e-05,0.008352800039574504,2000,1999687
MMG,8000,6000,9.376172021502688e-05,7.048780699959025,2000,1999687
SoA heuristic,20,15,0.039473684210526314,6.909994408488274e-05,5,12
MMG,20,15,0.039473684210526314,0.00027849990874528885,5,12
SoA heuristic,40,30,0.019230769230769232,3.2499898225069046e-05,10,52
MMG,40,30,0.019230769230769232,0.00020730006508529186,10,52
SoA heuristic,100,75,0.007575757575757576,5.7499855756759644e-05,25,313
MMG,100,75,0.007575757575757576,0.0009027000050991774,25,313
SoA heuristic,200,150,0.0037688442211055275,0.00011609983630478382,50,1271
MMG,200,150,0.0037688442211055275,0.005446000024676323,50,1271
SoA heuristic,400,300,0.0018796992481203006,0.000582600012421608,100,5013
MMG,400,300,0.0018796992481203006,0.011165600037202239,100,5013
SoA heuristic,600,450,0.0012520868113522537,0.00032679992727935314,150,11263
MMG,600,450,0.0012520868113522537,0.03521959995850921,150,11263
SoA heuristic,1000,750,0.0007507507507507507,0.0013405000790953636,250,31135
MMG,1000,750,0.0007507507507507507,0.0957396999001503,250,31135
SoA heuristic,2000,1500,0.00037518759379689845,0.0010806999634951353,500,125069
MMG,2000,1500,0.00037518759379689845,0.4378872001543641,500,125069
SoA heuristic,4000,3000,0.00018754688672168043,0.0027674001175910234,1000,499654
MMG,4000,3000,0.00018754688672168043,2.030292799929157,1000,499654
SoA heuristic,8000,6000,9.376172021502688e-05,0.007247000001370907,2000,1998936
MMG,8000,6000,9.376172021502688e-05,7.036871399963275,2000,1998936
SoA heuristic,20,15,0.039473684210526314,6.289989687502384e-05,5,10
MMG,20,15,0.039473684210526314,0.0002549001947045326,5,10
SoA heuristic,40,30,0.019230769230769232,9.34000127017498e-05,10,51
MMG,40,30,0.019230769230769232,0.00028709997422993183,10,51
SoA heuristic,100,75,0.007575757575757576,0.0001580999232828617,25,287
MMG,100,75,0.007575757575757576,0.0012625001836568117,25,287
SoA heuristic,200,150,0.0037688442211055275,0.00010320008732378483,50,1216
MMG,200,150,0.0037688442211055275,0.005181499989703298,50,1216
SoA heuristic,400,300,0.0018796992481203006,0.0005544000305235386,100,5028
MMG,400,300,0.0018796992481203006,0.0189026000443846,100,5028
SoA heuristic,600,450,0.0012520868113522537,0.0008079998660832644,150,11226
MMG,600,450,0.0012520868113522537,0.03246930008754134,150,11226
SoA heuristic,1000,750,0.0007507507507507507,0.0005483999848365784,250,31297
MMG,1000,750,0.0007507507507507507,0.07205269997939467,250,31297
SoA heuristic,2000,1500,0.00037518759379689845,0.0014711001422256231,500,125062
MMG,2000,1500,0.00037518759379689845,0.37360840011388063,500,125062
SoA heuristic,4000,3000,0.00018754688672168043,0.002274199854582548,1000,500590
MMG,4000,3000,0.00018754688672168043,1.5993456998839974,1000,500590
SoA heuristic,8000,6000,9.376172021502688e-05,0.005227499874308705,2000,2000304
MMG,8000,6000,9.376172021502688e-05,6.125658100005239,2000,2000304
SoA heuristic,20,15,0.039473684210526314,5.7800207287073135e-05,5,12
MMG,20,15,0.039473684210526314,0.0002577998675405979,5,12
SoA heuristic,40,30,0.019230769230769232,8.220016025006771e-05,10,49
MMG,40,30,0.019230769230769232,0.00034559983760118484,10,49
SoA heuristic,100,75,0.007575757575757576,5.8399979025125504e-05,25,309
MMG,100,75,0.007575757575757576,0.0014354998711496592,25,309
SoA heuristic,200,150,0.0037688442211055275,0.00010339985601603985,50,1220
MMG,200,150,0.0037688442211055275,0.005570000037550926,50,1220
SoA heuristic,400,300,0.0018796992481203006,0.0005395999178290367,100,5058
MMG,400,300,0.0018796992481203006,0.02319770003668964,100,5058
SoA heuristic,600,450,0.0012520868113522537,0.0007680999115109444,150,11129
MMG,600,450,0.0012520868113522537,0.03631979995407164,150,11129
SoA heuristic,1000,750,0.0007507507507507507,0.0004964000545442104,250,31309
MMG,1000,750,0.0007507507507507507,0.13798670005053282,250,31309
SoA heuristic,2000,1500,0.00037518759379689845,0.0029935999773442745,500,124640
MMG,2000,1500,0.00037518759379689845,0.39067670004442334,500,124640
SoA heuristic,4000,3000,0.00018754688672168043,0.0026901999954134226,1000,500219
MMG,4000,3000,0.00018754688672168043,1.6568793000187725,1000,500219
SoA heuristic,8000,6000,9.376172021502688e-05,0.005301899975165725,2000,1998731
MMG,8000,6000,9.376172021502688e-05,6.195057699922472,2000,1998731
SoA heuristic,20,15,0.039473684210526314,8.889986202120781e-05,5,10
MMG,20,15,0.039473684210526314,0.0003089001402258873,5,10
SoA heuristic,40,30,0.019230769230769232,0.00010180007666349411,10,44
MMG,40,30,0.019230769230769232,0.0006895000115036964,10,44
SoA heuristic,100,75,0.007575757575757576,0.0001884999219328165,25,319
MMG,100,75,0.007575757575757576,0.002843800000846386,25,319
SoA heuristic,200,150,0.0037688442211055275,0.0003310998436063528,50,1261
MMG,200,150,0.0037688442211055275,0.010281399823725224,50,1261
SoA heuristic,400,300,0.0018796992481203006,0.000642100116237998,100,5012
MMG,400,300,0.0018796992481203006,0.03713420010171831,100,5012
SoA heuristic,600,450,0.0012520868113522537,0.0009457999840378761,150,11283
MMG,600,450,0.0012520868113522537,0.08228000020608306,150,11283
SoA heuristic,1000,750,0.0007507507507507507,0.001672100042924285,250,31387
MMG,1000,750,0.0007507507507507507,0.2173693000804633,250,31387
SoA heuristic,2000,1500,0.00037518759379689845,0.003982800059020519,500,125388
MMG,2000,1500,0.00037518759379689845,0.8872694000601768,500,125388
SoA heuristic,4000,3000,0.00018754688672168043,0.008608900010585785,1000,500259
MMG,4000,3000,0.00018754688672168043,3.7512600000482053,1000,500259
SoA heuristic,8000,6000,9.376172021502688e-05,0.017437899950891733,2000,2001469
MMG,8000,6000,9.376172021502688e-05,14.55486089992337,2000,2001469
SoA heuristic,20,15,0.039473684210526314,3.090011887252331e-05,5,12
MMG,20,15,0.039473684210526314,9.75998118519783e-05,5,12
SoA heuristic,40,30,0.019230769230769232,3.4300144761800766e-05,10,47
MMG,40,30,0.019230769230769232,0.00022849999368190765,10,47
SoA heuristic,100,75,0.007575757575757576,6.240000948309898e-05,25,306
MMG,100,75,0.007575757575757576,0.0009168998803943396,25,306
SoA heuristic,200,150,0.0037688442211055275,0.00011019990779459476,50,1214
MMG,200,150,0.0037688442211055275,0.0031647998839616776,50,1214
SoA heuristic,400,300,0.0018796992481203006,0.00020979996770620346,100,4987
MMG,400,300,0.0018796992481203006,0.011996299959719181,100,4987
SoA heuristic,600,450,0.0012520868113522537,0.0003149001859128475,150,11229
MMG,600,450,0.0012520868113522537,0.02648550015874207,150,11229
SoA heuristic,1000,750,0.0007507507507507507,0.0006597000174224377,250,31183
MMG,1000,750,0.0007507507507507507,0.07191909989342093,250,31183
SoA heuristic,2000,1500,0.00037518759379689845,0.0011347997933626175,500,124604
MMG,2000,1500,0.00037518759379689845,0.2857828000560403,500,124604
SoA heuristic,4000,3000,0.00018754688672168043,0.0026455000042915344,1000,499865
MMG,4000,3000,0.00018754688672168043,1.2061276000458747,1000,499865
SoA heuristic,8000,6000,9.376172021502688e-05,0.005613400135189295,2000,2001098
MMG,8000,6000,9.376172021502688e-05,5.115615100134164,2000,2001098
SoA heuristic,20,15,0.039473684210526314,3.220001235604286e-05,5,14
MMG,20,15,0.039473684210526314,0.00010009994730353355,5,14
SoA heuristic,40,30,0.019230769230769232,3.260001540184021e-05,10,54
MMG,40,30,0.019230769230769232,0.00022789998911321163,10,54
SoA heuristic,100,75,0.007575757575757576,5.929986946284771e-05,25,294
MMG,100,75,0.007575757575757576,0.0009391999337822199,25,294
SoA heuristic,200,150,0.0037688442211055275,0.00014779996126890182,50,1235
MMG,200,150,0.0037688442211055275,0.003814700059592724,50,1235
SoA heuristic,400,300,0.0018796992481203006,0.00024410011246800423,100,5071
MMG,400,300,0.0018796992481203006,0.011192299891263247,100,5071
SoA heuristic,600,450,0.0012520868113522537,0.0002889998722821474,150,11184
MMG,600,450,0.0012520868113522537,0.025428300024941564,150,11184
SoA heuristic,1000,750,0.0007507507507507507,0.0005837001372128725,250,31086
MMG,1000,750,0.0007507507507507507,0.0730051000136882,250,31086
SoA heuristic,2000,1500,0.00037518759379689845,0.0011382999364286661,500,124760
MMG,2000,1500,0.00037518759379689845,0.2879066001623869,500,124760
SoA heuristic,4000,3000,0.00018754688672168043,0.0024190000258386135,1000,500014
MMG,4000,3000,0.00018754688672168043,1.1847558000590652,1000,500014
SoA heuristic,8000,6000,9.376172021502688e-05,0.006463899975642562,2000,2000065
MMG,8000,6000,9.376172021502688e-05,4.73445860017091,2000,2000065
SoA heuristic,20,15,0.039473684210526314,3.160000778734684e-05,5,11
MMG,20,15,0.039473684210526314,0.00010080006904900074,5,11
SoA heuristic,40,30,0.019230769230769232,3.520003519952297e-05,10,50
MMG,40,30,0.019230769230769232,0.0002264000941067934,10,50
SoA heuristic,100,75,0.007575757575757576,6.149988621473312e-05,25,322
MMG,100,75,0.007575757575757576,0.001006999984383583,25,322
SoA heuristic,200,150,0.0037688442211055275,0.00010649999603629112,50,1279
MMG,200,150,0.0037688442211055275,0.003222099971026182,50,1279
SoA heuristic,400,300,0.0018796992481203006,0.00021410011686384678,100,5041
MMG,400,300,0.0018796992481203006,0.012298299930989742,100,5041
SoA heuristic,600,450,0.0012520868113522537,0.00031960010528564453,150,11342
MMG,600,450,0.0012520868113522537,0.026730000041425228,150,11342
SoA heuristic,1000,750,0.0007507507507507507,0.000597700010985136,250,31039
MMG,1000,750,0.0007507507507507507,0.07286539999768138,250,31039
SoA heuristic,2000,1500,0.00037518759379689845,0.0011654999107122421,500,124768
MMG,2000,1500,0.00037518759379689845,0.291226799832657,500,124768
SoA heuristic,4000,3000,0.00018754688672168043,0.0025074000004678965,1000,499810
MMG,4000,3000,0.00018754688672168043,1.1969399999361485,1000,499810
SoA heuristic,8000,6000,9.376172021502688e-05,0.005863700062036514,2000,2000199
MMG,8000,6000,9.376172021502688e-05,4.6393515998497605,2000,2000199
SoA heuristic,20,15,0.039473684210526314,3.2300129532814026e-05,5,14
MMG,20,15,0.039473684210526314,0.00010469998233020306,5,14
SoA heuristic,40,30,0.019230769230769232,3.3800024539232254e-05,10,57
MMG,40,30,0.019230769230769232,0.00022909999825060368,10,57
SoA heuristic,100,75,0.007575757575757576,5.950010381639004e-05,25,295
MMG,100,75,0.007575757575757576,0.0009171999990940094,25,295
SoA heuristic,200,150,0.0037688442211055275,0.00011079991236329079,50,1213
MMG,200,150,0.0037688442211055275,0.003189499955624342,50,1213
SoA heuristic,400,300,0.0018796992481203006,0.00023530004546046257,100,4977
MMG,400,300,0.0018796992481203006,0.012017900124192238,100,4977
SoA heuristic,600,450,0.0012520868113522537,0.00031400006264448166,150,11309
MMG,600,450,0.0012520868113522537,0.029939800035208464,150,11309
SoA heuristic,1000,750,0.0007507507507507507,0.0005636999849230051,250,31263
MMG,1000,750,0.0007507507507507507,0.07167219999246299,250,31263
SoA heuristic,2000,1500,0.00037518759379689845,0.0012338999658823013,500,125025
MMG,2000,1500,0.00037518759379689845,0.28650150005705655,500,125025
SoA heuristic,4000,3000,0.00018754688672168043,0.0028979999478906393,1000,500625
MMG,4000,3000,0.00018754688672168043,1.1941068000160158,1000,500625
SoA heuristic,8000,6000,9.376172021502688e-05,0.006122700171545148,2000,2000676
MMG,8000,6000,9.376172021502688e-05,4.760103600099683,2000,2000676
SoA heuristic,20,15,0.039473684210526314,3.200001083314419e-05,5,13
MMG,20,15,0.039473684210526314,9.930017404258251e-05,5,13
SoA heuristic,40,30,0.019230769230769232,3.520003519952297e-05,10,39
MMG,40,30,0.019230769230769232,0.0002297998871654272,10,39
SoA heuristic,100,75,0.007575757575757576,6.409990601241589e-05,25,317
MMG,100,75,0.007575757575757576,0.0009535001590847969,25,317
SoA heuristic,200,150,0.0037688442211055275,0.00010890001431107521,50,1257
MMG,200,150,0.0037688442211055275,0.003187800059095025,50,1257
SoA heuristic,400,300,0.0018796992481203006,0.00023410003632307053,100,5055
MMG,400,300,0.0018796992481203006,0.012139200000092387,100,5055
SoA heuristic,600,450,0.0012520868113522537,0.00033340021036565304,150,11139
MMG,600,450,0.0012520868113522537,0.02712809992954135,150,11139
SoA heuristic,1000,750,0.0007507507507507507,0.0005547001492232084,250,31298
MMG,1000,750,0.0007507507507507507,0.07346839993260801,250,31298
SoA heuristic,2000,1500,0.00037518759379689845,0.0011938000097870827,500,125005
MMG,2000,1500,0.00037518759379689845,0.29034770000725985,500,125005
SoA heuristic,4000,3000,0.00018754688672168043,0.0029384999070316553,1000,499678
MMG,4000,3000,0.00018754688672168043,1.172889499925077,1000,499678
SoA heuristic,8000,6000,9.376172021502688e-05,0.005583500023931265,2000,2001007
MMG,8000,6000,9.376172021502688e-05,4.852208599913865,2000,2001007
SoA heuristic,20,15,0.039473684210526314,3.120000474154949e-05,5,9
MMG,20,15,0.039473684210526314,9.900005534291267e-05,5,9
SoA heuristic,40,30,0.019230769230769232,3.210012800991535e-05,10,55
MMG,40,30,0.019230769230769232,0.000220100162550807,10,55
SoA heuristic,100,75,0.007575757575757576,6.13001175224781e-05,25,335
MMG,100,75,0.007575757575757576,0.0009320999961346388,25,335
SoA heuristic,200,150,0.0037688442211055275,0.0001067998819053173,50,1249
MMG,200,150,0.0037688442211055275,0.003213200019672513,50,1249
SoA heuristic,400,300,0.0018796992481203006,0.0002326001413166523,100,5013
MMG,400,300,0.0018796992481203006,0.012002400122582912,100,5013
SoA heuristic,600,450,0.0012520868113522537,0.00035339989699423313,150,11311
MMG,600,450,0.0012520868113522537,0.026908200001344085,150,11311
SoA heuristic,1000,750,0.0007507507507507507,0.0005922999698668718,250,31396
MMG,1000,750,0.0007507507507507507,0.07286450010724366,250,31396
SoA heuristic,2000,1500,0.00037518759379689845,0.0012125000357627869,500,124885
MMG,2000,1500,0.00037518759379689845,0.2880826999899,500,124885
SoA heuristic,4000,3000,0.00018754688672168043,0.0025198000948876143,1000,499854
MMG,4000,3000,0.00018754688672168043,1.197449600091204,1000,499854
SoA heuristic,8000,6000,9.376172021502688e-05,0.005104399984702468,2000,2000555
MMG,8000,6000,9.376172021502688e-05,4.88001299998723,2000,2000555
SoA heuristic,20,15,0.039473684210526314,3.1400006264448166e-05,5,15
MMG,20,15,0.039473684210526314,9.849993512034416e-05,5,15
SoA heuristic,40,30,0.019230769230769232,3.269989974796772e-05,10,53
MMG,40,30,0.019230769230769232,0.00022820010781288147,10,53
SoA heuristic,100,75,0.007575757575757576,6.079999729990959e-05,25,308
MMG,100,75,0.007575757575757576,0.0009336001239717007,25,308
SoA heuristic,200,150,0.0037688442211055275,0.00011250004172325134,50,1218
MMG,200,150,0.0037688442211055275,0.003304100129753351,50,1218
SoA heuristic,400,300,0.0018796992481203006,0.00021340022794902325,100,4958
MMG,400,300,0.0018796992481203006,0.012216900009661913,100,4958
SoA heuristic,600,450,0.0012520868113522537,0.00033110007643699646,150,11247
MMG,600,450,0.0012520868113522537,0.02707930002361536,150,11247
SoA heuristic,1000,750,0.0007507507507507507,0.0005687999073415995,250,31340
MMG,1000,750,0.0007507507507507507,0.06846909993328154,250,31340
SoA heuristic,2000,1500,0.00037518759379689845,0.0010893999133259058,500,124751
MMG,2000,1500,0.00037518759379689845,0.29087119991891086,500,124751
SoA heuristic,4000,3000,0.00018754688672168043,0.002583199879154563,1000,499754
MMG,4000,3000,0.00018754688672168043,1.1801086000632495,1000,499754
SoA heuristic,8000,6000,9.376172021502688e-05,0.00584200001321733,2000,1999489
MMG,8000,6000,9.376172021502688e-05,4.808213300071657,2000,1999489
SoA heuristic,20,15,0.039473684210526314,3.1299889087677e-05,5,11
MMG,20,15,0.039473684210526314,9.949994273483753e-05,5,11
SoA heuristic,40,30,0.019230769230769232,3.609992563724518e-05,10,46
MMG,40,30,0.019230769230769232,0.0002484999131411314,10,46
SoA heuristic,100,75,0.007575757575757576,6.309989839792252e-05,25,325
MMG,100,75,0.007575757575757576,0.0009614999871701002,25,325
SoA heuristic,200,150,0.0037688442211055275,0.00013529998250305653,50,1246
MMG,200,150,0.0037688442211055275,0.0031931998673826456,50,1246
SoA heuristic,400,300,0.0018796992481203006,0.00020949984900653362,100,5068
MMG,400,300,0.0018796992481203006,0.013386999955400825,100,5068
SoA heuristic,600,450,0.0012520868113522537,0.00031560007482767105,150,11136
MMG,600,450,0.0012520868113522537,0.02696059993468225,150,11136
SoA heuristic,1000,750,0.0007507507507507507,0.000571100041270256,250,31122
MMG,1000,750,0.0007507507507507507,0.07258870010264218,250,31122
SoA heuristic,2000,1500,0.00037518759379689845,0.0012193999718874693,500,124753
MMG,2000,1500,0.00037518759379689845,0.2898067000787705,500,124753
SoA heuristic,4000,3000,0.00018754688672168043,0.0024200999177992344,1000,500474
MMG,4000,3000,0.00018754688672168043,1.2254289998672903,1000,500474
SoA heuristic,8000,6000,9.376172021502688e-05,0.0054265998769551516,2000,2001624
MMG,8000,6000,9.376172021502688e-05,4.70813319995068,2000,2001624
SoA heuristic,20,15,0.039473684210526314,3.660004585981369e-05,5,10
MMG,20,15,0.039473684210526314,0.00012869993224740028,5,10
SoA heuristic,40,30,0.019230769230769232,4.42001037299633e-05,10,53
MMG,40,30,0.019230769230769232,0.00031160004436969757,10,53
SoA heuristic,100,75,0.007575757575757576,8.310005068778992e-05,25,316
MMG,100,75,0.007575757575757576,0.0012743000406771898,25,316
SoA heuristic,200,150,0.0037688442211055275,0.00010279985144734383,50,1290
MMG,200,150,0.0037688442211055275,0.0029904998373240232,50,1290
SoA heuristic,400,300,0.0018796992481203006,0.0002031000331044197,100,4951
MMG,400,300,0.0018796992481203006,0.011287699919193983,100,4951
SoA heuristic,600,450,0.0012520868113522537,0.00030640000477433205,150,11367
MMG,600,450,0.0012520868113522537,0.026666400022804737,150,11367
SoA heuristic,1000,750,0.0007507507507507507,0.0005460998509079218,250,31117
MMG,1000,750,0.0007507507507507507,0.07213129987940192,250,31117
SoA heuristic,2000,1500,0.00037518759379689845,0.001189099857583642,500,124951
MMG,2000,1500,0.00037518759379689845,0.29122260003350675,500,124951
SoA heuristic,4000,3000,0.00018754688672168043,0.0024659999180585146,1000,499253
MMG,4000,3000,0.00018754688672168043,1.2108760999981314,1000,499253
SoA heuristic,8000,6000,9.376172021502688e-05,0.005666700191795826,2000,1999217
MMG,8000,6000,9.376172021502688e-05,4.625647500157356,2000,1999217
SoA heuristic,20,15,0.039473684210526314,3.400002606213093e-05,5,12
MMG,20,15,0.039473684210526314,0.0001026000827550888,5,12
SoA heuristic,40,30,0.019230769230769232,5.6399963796138763e-05,10,50
MMG,40,30,0.019230769230769232,0.00025919987820088863,10,50
SoA heuristic,100,75,0.007575757575757576,6.500002928078175e-05,25,294
MMG,100,75,0.007575757575757576,0.0010047999676316977,25,294
SoA heuristic,200,150,0.0037688442211055275,0.00011039990931749344,50,1268
MMG,200,150,0.0037688442211055275,0.0033392999321222305,50,1268
SoA heuristic,400,300,0.0018796992481203006,0.00030630012042820454,100,5035
MMG,400,300,0.0018796992481203006,0.012196799973025918,100,5035
SoA heuristic,600,450,0.0012520868113522537,0.0003389997873455286,150,11215
MMG,600,450,0.0012520868113522537,0.02711899997666478,150,11215
SoA heuristic,1000,750,0.0007507507507507507,0.0006089999806135893,250,31268
MMG,1000,750,0.0007507507507507507,0.07394680008292198,250,31268
SoA heuristic,2000,1500,0.00037518759379689845,0.0012781000696122646,500,125062
MMG,2000,1500,0.00037518759379689845,0.28267630003392696,500,125062
SoA heuristic,4000,3000,0.00018754688672168043,0.0022671001497656107,1000,499524
MMG,4000,3000,0.00018754688672168043,1.209985899971798,1000,499524
SoA heuristic,8000,6000,9.376172021502688e-05,0.052452199859544635,2000,1999153
MMG,8000,6000,9.376172021502688e-05,4.845380500191823,2000,1999153
SoA heuristic,20,15,0.039473684210526314,5.359994247555733e-05,5,10
MMG,20,15,0.039473684210526314,0.0001626999583095312,5,10
SoA heuristic,40,30,0.019230769230769232,5.5499840527772903e-05,10,43
MMG,40,30,0.019230769230769232,0.00027760001830756664,10,43
SoA heuristic,100,75,0.007575757575757576,6.360001862049103e-05,25,318
MMG,100,75,0.007575757575757576,0.0009682001546025276,25,318
SoA heuristic,200,150,0.0037688442211055275,0.00011319993063807487,50,1256
MMG,200,150,0.0037688442211055275,0.0035776998847723007,50,1256
SoA heuristic,400,300,0.0018796992481203006,0.0003413998056203127,100,4967
MMG,400,300,0.0018796992481203006,0.012439199956133962,100,4967
SoA heuristic,600,450,0.0012520868113522537,0.00036710011772811413,150,11142
MMG,600,450,0.0012520868113522537,0.026077999966219068,150,11142
SoA heuristic,1000,750,0.0007507507507507507,0.0006153001450002193,250,31286
MMG,1000,750,0.0007507507507507507,0.0738332998007536,250,31286
SoA heuristic,2000,1500,0.00037518759379689845,0.0011533999349921942,500,125043
MMG,2000,1500,0.00037518759379689845,0.28293829993344843,500,125043
SoA heuristic,4000,3000,0.00018754688672168043,0.003436099970713258,1000,499740
MMG,4000,3000,0.00018754688672168043,1.301730099832639,1000,499740
SoA heuristic,8000,6000,9.376172021502688e-05,0.006329500116407871,2000,2000087
MMG,8000,6000,9.376172021502688e-05,5.164786099921912,2000,2000087
