name,nodes,edges,density,time,result_set,result_w
SoA heuristic,20,15,0.039473684210526314,7.220008410513401e-05,5,29
MMG,20,15,0.039473684210526314,0.0003027999773621559,5,29
SoA heuristic,40,30,0.019230769230769232,5.769985727965832e-05,10,119
MMG,40,30,0.019230769230769232,0.00034559983760118484,10,119
SoA heuristic,100,75,0.007575757575757576,6.010010838508606e-05,25,629
MMG,100,75,0.007575757575757576,0.0013954001478850842,25,629
SoA heuristic,200,150,0.0037688442211055275,0.0001058999914675951,50,2534
MMG,200,150,0.0037688442211055275,0.003727999981492758,50,2534
SoA heuristic,400,300,0.0018796992481203006,0.00019489997066557407,100,9985
MMG,400,300,0.0018796992481203006,0.016525099985301495,100,9985
SoA heuristic,600,450,0.0012520868113522537,0.0004681998398154974,150,22640
MMG,600,450,0.0012520868113522537,0.03470410010777414,150,22640
SoA heuristic,1000,750,0.0007507507507507507,0.0009842999279499054,250,62516
MMG,1000,750,0.0007507507507507507,0.09635859983973205,250,62516
SoA heuristic,2000,1500,0.00037518759379689845,0.0031186998821794987,500,250026
MMG,2000,1500,0.00037518759379689845,0.41768479999154806,500,250026
SoA heuristic,4000,3000,0.00018754688672168043,0.002161900047212839,1000,1001093
MMG,4000,3000,0.00018754688672168043,1.807566500036046,1000,1001093
SoA heuristic,8000,6000,9.376172021502688e-05,0.013438699999824166,2000,4000220
MMG,8000,6000,9.376172021502688e-05,7.347322899848223,2000,4000220
SoA heuristic,20,15,0.039473684210526314,2.8899870812892914e-05,5,23
MMG,20,15,0.039473684210526314,9.410013444721699e-05,5,23
SoA heuristic,40,30,0.019230769230769232,3.1800009310245514e-05,10,125
MMG,40,30,0.019230769230769232,0.00020690006203949451,10,125
SoA heuristic,100,75,0.007575757575757576,5.720020271837711e-05,25,617
MMG,100,75,0.007575757575757576,0.0009006001055240631,25,617
SoA heuristic,200,150,0.0037688442211055275,0.00011380016803741455,50,2501
MMG,200,150,0.0037688442211055275,0.003002299927175045,50,2501
SoA heuristic,400,300,0.0018796992481203006,0.0001970999874174595,100,9938
MMG,400,300,0.0018796992481203006,0.011483500013127923,100,9938
SoA heuristic,600,450,0.0012520868113522537,0.0007747001945972443,150,22636
MMG,600,450,0.0012520868113522537,0.040848700096830726,150,22636
SoA heuristic,1000,750,0.0007507507507507507,0.0015249999705702066,250,62646
MMG,1000,750,0.0007507507507507507,0.10601849993690848,250,62646
SoA heuristic,2000,1500,0.00037518759379689845,0.0011378999333828688,500,249641
MMG,2000,1500,0.00037518759379689845,0.46916029998101294,500,249641
SoA heuristic,4000,3000,0.00018754688672168043,0.005133199971169233,1000,1001312
MMG,4000,3000,0.00018754688672168043,1.862516899826005,1000,1001312
SoA heuristic,8000,6000,9.376172021502688e-05,0.005427500000223517,2000,4001751
MMG,8000,6000,9.376172021502688e-05,7.397154600126669,2000,4001751
SoA heuristic,20,15,0.039473684210526314,4.279986023902893e-05,5,21
MMG,20,15,0.039473684210526314,0.00016249995678663254,5,21
SoA heuristic,40,30,0.019230769230769232,5.869986489415169e-05,10,81
MMG,40,30,0.019230769230769232,0.0004406999796628952,10,81
SoA heuristic,100,75,0.007575757575757576,0.0001689000055193901,25,616
MMG,100,75,0.007575757575757576,0.002482800045982003,25,616
SoA heuristic,200,150,0.0037688442211055275,0.00036370009183883667,50,2571
MMG,200,150,0.0037688442211055275,0.00846470007672906,50,2571
SoA heuristic,400,300,0.0018796992481203006,0.0004865999799221754,100,10075
MMG,400,300,0.0018796992481203006,0.019994899863377213,100,10075
SoA heuristic,600,450,0.0012520868113522537,0.000840499997138977,150,22234
MMG,600,450,0.0012520868113522537,0.033438900019973516,150,22234
SoA heuristic,1000,750,0.0007507507507507507,0.0013946001417934895,250,62495
MMG,1000,750,0.0007507507507507507,0.07931860000826418,250,62495
SoA heuristic,2000,1500,0.00037518759379689845,0.002196699846535921,500,250015
MMG,2000,1500,0.00037518759379689845,0.436269500060007,500,250015
SoA heuristic,4000,3000,0.00018754688672168043,0.0026418000925332308,1000,1000122
MMG,4000,3000,0.00018754688672168043,1.8046946998219937,1000,1000122
SoA heuristic,8000,6000,9.376172021502688e-05,0.007610799977555871,2000,4000554
MMG,8000,6000,9.376172021502688e-05,6.663219799986109,2000,4000554
SoA heuristic,20,15,0.039473684210526314,4.009995609521866e-05,5,24
MMG,20,15,0.039473684210526314,0.00010739988647401333,5,24
SoA heuristic,40,30,0.019230769230769232,5.769985727965832e-05,10,111
MMG,40,30,0.019230769230769232,0.0005092998035252094,10,111
SoA heuristic,100,75,0.007575757575757576,0.0001029998529702425,25,647
MMG,100,75,0.007575757575757576,0.001484900014474988,25,647
SoA heuristic,200,150,0.0037688442211055275,0.00011319993063807487,50,2545
MMG,200,150,0.0037688442211055275,0.0031568999402225018,50,2545
SoA heuristic,400,300,0.0018796992481203006,0.00022000004537403584,100,9901
MMG,400,300,0.0018796992481203006,0.012074799975380301,100,9901
SoA heuristic,600,450,0.0012520868113522537,0.0003309000749140978,150,22542
MMG,600,450,0.0012520868113522537,0.028251900104805827,150,22542
SoA heuristic,1000,750,0.0007507507507507507,0.0005926000885665417,250,62701
MMG,1000,750,0.0007507507507507507,0.07207160000689328,250,62701
SoA heuristic,2000,1500,0.00037518759379689845,0.0012462001759558916,500,249401
MMG,2000,1500,0.00037518759379689845,0.30455380002968013,500,249401
SoA heuristic,4000,3000,0.00018754688672168043,0.002505799988284707,1000,999700
MMG,4000,3000,0.00018754688672168043,1.2186696999706328,1000,999700
SoA heuristic,8000,6000,9.376172021502688e-05,0.005144499940797687,2000,3999440
MMG,8000,6000,9.376172021502688e-05,6.397063700016588,2000,3999440
SoA heuristic,20,15,0.039473684210526314,3.850017674267292e-05,5,29
MMG,20,15,0.039473684210526314,0.00011470005847513676,5,29
SoA heuristic,40,30,0.019230769230769232,6.909994408488274e-05,10,105
MMG,40,30,0.019230769230769232,0.00029639992862939835,10,105
SoA heuristic,100,75,0.007575757575757576,7.770000956952572e-05,25,587
MMG,100,75,0.007575757575757576,0.0011655997950583696,25,587
SoA heuristic,200,150,0.0037688442211055275,0.0001338000874966383,50,2490
MMG,200,150,0.0037688442211055275,0.00377509999088943,50,2490
SoA heuristic,400,300,0.0018796992481203006,0.0002539998386055231,100,9869
MMG,400,300,0.0018796992481203006,0.013663300080224872,100,9869
SoA heuristic,600,450,0.0012520868113522537,0.00037260004319250584,150,22422
MMG,600,450,0.0012520868113522537,0.0319730001501739,150,22422
SoA heuristic,1000,750,0.0007507507507507507,0.0007609000895172358,250,62422
MMG,1000,750,0.0007507507507507507,0.09171200008131564,250,62422
SoA heuristic,2000,1500,0.00037518759379689845,0.0014861999079585075,500,250064
MMG,2000,1500,0.00037518759379689845,0.36066939984448254,500,250064
SoA heuristic,4000,3000,0.00018754688672168043,0.03186980006285012,1000,1000171
MMG,4000,3000,0.00018754688672168043,1.3482106002047658,1000,1000171
SoA heuristic,8000,6000,9.376172021502688e-05,0.0071072999853640795,2000,3999100
MMG,8000,6000,9.376172021502688e-05,5.69672070001252,2000,3999100
SoA heuristic,20,15,0.039473684210526314,3.569992259144783e-05,5,25
MMG,20,15,0.039473684210526314,0.00012470013462007046,5,25
SoA heuristic,40,30,0.019230769230769232,3.6400044336915016e-05,10,94
MMG,40,30,0.019230769230769232,0.0002725999802350998,10,94
SoA heuristic,100,75,0.007575757575757576,7.189996540546417e-05,25,647
MMG,100,75,0.007575757575757576,0.001137500163167715,25,647
SoA heuristic,200,150,0.0037688442211055275,0.0001322000753134489,50,2470
MMG,200,150,0.0037688442211055275,0.003675200045108795,50,2470
SoA heuristic,400,300,0.0018796992481203006,0.0002527001779526472,100,10040
MMG,400,300,0.0018796992481203006,0.014037800021469593,100,10040
SoA heuristic,600,450,0.0012520868113522537,0.00036399997770786285,150,22665
MMG,600,450,0.0012520868113522537,0.030369400046765804,150,22665
SoA heuristic,1000,750,0.0007507507507507507,0.0006711999885737896,250,61932
MMG,1000,750,0.0007507507507507507,0.08308589993976057,250,61932
SoA heuristic,2000,1500,0.00037518759379689845,0.0014720999170094728,500,249923
MMG,2000,1500,0.00037518759379689845,0.33486040006391704,500,249923
SoA heuristic,4000,3000,0.00018754688672168043,0.0028077999595552683,1000,999789
MMG,4000,3000,0.00018754688672168043,1.400489900028333,1000,999789
SoA heuristic,8000,6000,9.376172021502688e-05,0.005871400004252791,2000,4000267
MMG,8000,6000,9.376172021502688e-05,5.583343500038609,2000,4000267
SoA heuristic,20,15,0.039473684210526314,6.729993037879467e-05,5,29
MMG,20,15,0.039473684210526314,0.00025899987667798996,5,29
SoA heuristic,40,30,0.019230769230769232,4.259985871613026e-05,10,112
MMG,40,30,0.019230769230769232,0.0004893001168966293,10,112
SoA heuristic,100,75,0.007575757575757576,0.00019040005281567574,25,658
MMG,100,75,0.007575757575757576,0.002682300051674247,25,658
SoA heuristic,200,150,0.0037688442211055275,0.0003355001099407673,50,2561
MMG,200,150,0.0037688442211055275,0.00886709988117218,50,2561
SoA heuristic,400,300,0.0018796992481203006,0.000242199981585145,100,9984
MMG,400,300,0.0018796992481203006,0.01166899991221726,100,9984
SoA heuristic,600,450,0.0012520868113522537,0.00031250016763806343,150,22342
MMG,600,450,0.0012520868113522537,0.03832509997300804,150,22342
SoA heuristic,1000,750,0.0007507507507507507,0.0008598000276833773,250,62535
MMG,1000,750,0.0007507507507507507,0.13328239996917546,250,62535
SoA heuristic,2000,1500,0.00037518759379689845,0.0013551998417824507,500,249788
MMG,2000,1500,0.00037518759379689845,0.38563650008291006,500,249788
SoA heuristic,4000,3000,0.00018754688672168043,0.002517899964004755,1000,1000479
MMG,4000,3000,0.00018754688672168043,1.7227288999129087,1000,1000479
SoA heuristic,8000,6000,9.376172021502688e-05,0.05297590000554919,2000,3999025
MMG,8000,6000,9.376172021502688e-05,6.906016000080854,2000,3999025
SoA heuristic,20,15,0.039473684210526314,3.2400013878941536e-05,5,34
MMG,20,15,0.039473684210526314,0.00010349997319281101,5,34
SoA heuristic,40,30,0.019230769230769232,3.7800054997205734e-05,10,76
MMG,40,30,0.019230769230769232,0.0002468000166118145,10,76
SoA heuristic,100,75,0.007575757575757576,6.669992581009865e-05,25,610
MMG,100,75,0.007575757575757576,0.0009836999233812094,25,610
SoA heuristic,200,150,0.0037688442211055275,0.00011279992759227753,50,2454
MMG,200,150,0.0037688442211055275,0.003045800141990185,50,2454
SoA heuristic,400,300,0.0018796992481203006,0.00020510004833340645,100,10052
MMG,400,300,0.0018796992481203006,0.011246199952438474,100,10052
SoA heuristic,600,450,0.0012520868113522537,0.000286600086838007,150,22819
MMG,600,450,0.0012520868113522537,0.025619399966672063,150,22819
SoA heuristic,1000,750,0.0007507507507507507,0.0005969000048935413,250,62525
MMG,1000,750,0.0007507507507507507,0.07445849990472198,250,62525
SoA heuristic,2000,1500,0.00037518759379689845,0.0011858998332172632,500,250203
MMG,2000,1500,0.00037518759379689845,0.28240630007348955,500,250203
SoA heuristic,4000,3000,0.00018754688672168043,0.002288399962708354,1000,1000405
MMG,4000,3000,0.00018754688672168043,1.1976471999660134,1000,1000405
SoA heuristic,8000,6000,9.376172021502688e-05,0.005273299990221858,2000,4001165
MMG,8000,6000,9.376172021502688e-05,4.671925199916586,2000,4001165
SoA heuristic,20,15,0.039473684210526314,5.929986946284771e-05,5,32
MMG,20,15,0.039473684210526314,0.0003301000688225031,5,32
SoA heuristic,40,30,0.019230769230769232,8.150003850460052e-05,10,104
MMG,40,30,0.019230769230769232,0.0006164999213069677,10,104
SoA heuristic,100,75,0.007575757575757576,0.00014909985475242138,25,607
MMG,100,75,0.007575757575757576,0.0024544999469071627,25,607
SoA heuristic,200,150,0.0037688442211055275,0.00039840000681579113,50,2525
MMG,200,150,0.0037688442211055275,0.008333300007507205,50,2525
SoA heuristic,400,300,0.0018796992481203006,0.0005229001399129629,100,10109
MMG,400,300,0.0018796992481203006,0.016308499965816736,100,10109
SoA heuristic,600,450,0.0012520868113522537,0.0007058000192046165,150,22627
MMG,600,450,0.0012520868113522537,0.026672699954360723,150,22627
SoA heuristic,1000,750,0.0007507507507507507,0.0005503001157194376,250,62506
MMG,1000,750,0.0007507507507507507,0.12316350010223687,250,62506
SoA heuristic,2000,1500,0.00037518759379689845,0.0010635999497026205,500,250776
MMG,2000,1500,0.00037518759379689845,0.4806512000504881,500,250776
SoA heuristic,4000,3000,0.00018754688672168043,0.004546100040897727,1000,1002556
MMG,4000,3000,0.00018754688672168043,1.7531844000332057,1000,1002556
SoA heuristic,8000,6000,9.376172021502688e-05,0.0057570000644773245,2000,3999656
MMG,8000,6000,9.376172021502688e-05,6.992660700110719,2000,3999656
SoA heuristic,20,15,0.039473684210526314,5.13000413775444e-05,5,24
MMG,20,15,0.039473684210526314,0.00017840019427239895,5,24
SoA heuristic,40,30,0.019230769230769232,4.710000939667225e-05,10,98
MMG,40,30,0.019230769230769232,0.0002788000274449587,10,98
SoA heuristic,100,75,0.007575757575757576,8.819997310638428e-05,25,613
MMG,100,75,0.007575757575757576,0.0011715998407453299,25,613
SoA heuristic,200,150,0.0037688442211055275,0.0001759999431669712,50,2508
MMG,200,150,0.0037688442211055275,0.0036669999826699495,50,2508
SoA heuristic,400,300,0.0018796992481203006,0.0002623000182211399,100,10018
MMG,400,300,0.0018796992481203006,0.014452200150117278,100,10018
SoA heuristic,600,450,0.0012520868113522537,0.0003700000233948231,150,22466
MMG,600,450,0.0012520868113522537,0.031331999925896525,150,22466
SoA heuristic,1000,750,0.0007507507507507507,0.0008056999649852514,250,62359
MMG,1000,750,0.0007507507507507507,0.08601210010237992,250,62359
SoA heuristic,2000,1500,0.00037518759379689845,0.0014110999181866646,500,250919
MMG,2000,1500,0.00037518759379689845,0.34383139992132783,500,250919
SoA heuristic,4000,3000,0.00018754688672168043,0.0032284001354128122,1000,1001468
MMG,4000,3000,0.00018754688672168043,1.4531924000475556,1000,1001468
SoA heuristic,8000,6000,9.376172021502688e-05,0.014942199923098087,2000,3997717
MMG,8000,6000,9.376172021502688e-05,6.564841999905184,2000,3997717
SoA heuristic,20,15,0.039473684210526314,6.410013884305954e-05,5,35
MMG,20,15,0.039473684210526314,0.0002609000075608492,5,35
SoA heuristic,40,30,0.019230769230769232,8.979998528957367e-05,10,114
MMG,40,30,0.019230769230769232,0.0006806000601500273,10,114
SoA heuristic,100,75,0.007575757575757576,0.00015909993089735508,25,632
MMG,100,75,0.007575757575757576,0.0025341000873595476,25,632
SoA heuristic,200,150,0.0037688442211055275,0.0001191999763250351,50,2479
MMG,200,150,0.0037688442211055275,0.0074402999598532915,50,2479
SoA heuristic,400,300,0.0018796992481203006,0.00020620017312467098,100,10131
MMG,400,300,0.0018796992481203006,0.017242599977180362,100,10131
SoA heuristic,600,450,0.0012520868113522537,0.00031029991805553436,150,22374
MMG,600,450,0.0012520868113522537,0.045021799858659506,150,22374
SoA heuristic,1000,750,0.0007507507507507507,0.001178000122308731,250,62796
MMG,1000,750,0.0007507507507507507,0.15670499997213483,250,62796
SoA heuristic,2000,1500,0.00037518759379689845,0.0011213000398129225,500,249814
MMG,2000,1500,0.00037518759379689845,0.4478550001513213,500,249814
SoA heuristic,4000,3000,0.00018754688672168043,0.0029054998885840178,1000,1000123
MMG,4000,3000,0.00018754688672168043,1.7313964001368731,1000,1000123
SoA heuristic,8000,6000,9.376172021502688e-05,0.005469599971547723,2000,3999635
MMG,8000,6000,9.376172021502688e-05,7.200745200039819,2000,3999635
SoA heuristic,20,15,0.039473684210526314,4.319986328482628e-05,5,15
MMG,20,15,0.039473684210526314,0.00012609991244971752,5,15
SoA heuristic,40,30,0.019230769230769232,5.04001509398222e-05,10,97
MMG,40,30,0.019230769230769232,0.0002941000275313854,10,97
SoA heuristic,100,75,0.007575757575757576,0.00016729999333620071,25,612
MMG,100,75,0.007575757575757576,0.0025199998635798693,25,612
SoA heuristic,200,150,0.0037688442211055275,0.0003021999727934599,50,2580
MMG,200,150,0.0037688442211055275,0.008879999862983823,50,2580
SoA heuristic,400,300,0.0018796992481203006,0.00020539993420243263,100,10000
MMG,400,300,0.0018796992481203006,0.014395999955013394,100,10000
SoA heuristic,600,450,0.0012520868113522537,0.0002897998783737421,150,22293
MMG,600,450,0.0012520868113522537,0.048154500080272555,150,22293
SoA heuristic,1000,750,0.0007507507507507507,0.001506200060248375,250,62481
MMG,1000,750,0.0007507507507507507,0.14262189995497465,250,62481
SoA heuristic,2000,1500,0.00037518759379689845,0.0012870000209659338,500,250027
MMG,2000,1500,0.00037518759379689845,0.40465639997273684,500,250027
SoA heuristic,4000,3000,0.00018754688672168043,0.0036848001182079315,1000,1000166
MMG,4000,3000,0.00018754688672168043,2.015017000027001,1000,1000166
SoA heuristic,8000,6000,9.376172021502688e-05,0.004688899964094162,2000,3998603
MMG,8000,6000,9.376172021502688e-05,6.574424199992791,2000,3998603
SoA heuristic,20,15,0.039473684210526314,6.54999166727066e-05,5,22
MMG,20,15,0.039473684210526314,0.00036310008727014065,5,22
SoA heuristic,40,30,0.019230769230769232,4.220008850097656e-05,10,109
MMG,40,30,0.019230769230769232,0.0006530999671667814,10,109
SoA heuristic,100,75,0.007575757575757576,6.340001709759235e-05,25,631
MMG,100,75,0.007575757575757576,0.002077799988910556,25,631
SoA heuristic,200,150,0.0037688442211055275,0.00021079997532069683,50,2323
MMG,200,150,0.0037688442211055275,0.0038729000370949507,50,2323
SoA heuristic,400,300,0.0018796992481203006,0.0002077000681310892,100,9995
MMG,400,300,0.0018796992481203006,0.013029299909248948,100,9995
SoA heuristic,600,450,0.0012520868113522537,0.0008557999972254038,150,22713
MMG,600,450,0.0012520868113522537,0.05342229991219938,150,22713
SoA heuristic,1000,750,0.0007507507507507507,0.0016599998343735933,250,62408
MMG,1000,750,0.0007507507507507507,0.09809920005500317,250,62408
SoA heuristic,2000,1500,0.00037518759379689845,0.003303700126707554,500,249266
MMG,2000,1500,0.00037518759379689845,0.49706500000320375,500,249266
SoA heuristic,4000,3000,0.00018754688672168043,0.0032009000424295664,1000,1002010
MMG,4000,3000,0.00018754688672168043,1.549200899899006,1000,1002010
SoA heuristic,8000,6000,9.376172021502688e-05,0.01624429994262755,2000,4001589
MMG,8000,6000,9.376172021502688e-05,6.876329799881205,2000,4001589
SoA heuristic,20,15,0.039473684210526314,2.9300106689333916e-05,5,37
MMG,20,15,0.039473684210526314,9.819981642067432e-05,5,37
SoA heuristic,40,30,0.019230769230769232,3.179977647960186e-05,10,106
MMG,40,30,0.019230769230769232,0.0002305000089108944,10,106
SoA heuristic,100,75,0.007575757575757576,6.529991514980793e-05,25,605
MMG,100,75,0.007575757575757576,0.0013219001702964306,25,605
SoA heuristic,200,150,0.0037688442211055275,0.0002742998767644167,50,2472
MMG,200,150,0.0037688442211055275,0.00815330003388226,50,2472
SoA heuristic,400,300,0.0018796992481203006,0.00024170009419322014,100,10129
MMG,400,300,0.0018796992481203006,0.013407299993559718,100,10129
SoA heuristic,600,450,0.0012520868113522537,0.00045080017298460007,150,22540
MMG,600,450,0.0012520868113522537,0.03992719994857907,150,22540
SoA heuristic,1000,750,0.0007507507507507507,0.0006249998696148396,250,62648
MMG,1000,750,0.0007507507507507507,0.1167939999140799,250,62648
SoA heuristic,2000,1500,0.00037518759379689845,0.0013647000305354595,500,250331
MMG,2000,1500,0.00037518759379689845,0.43732529995031655,500,250331
SoA heuristic,4000,3000,0.00018754688672168043,0.0022865000646561384,1000,1000202
MMG,4000,3000,0.00018754688672168043,1.6821934999898076,1000,1000202
SoA heuristic,8000,6000,9.376172021502688e-05,0.005872099893167615,2000,3999562
MMG,8000,6000,9.376172021502688e-05,7.46835820004344,2000,3999562
SoA heuristic,20,15,0.039473684210526314,2.7099857106804848e-05,5,29
MMG,20,15,0.039473684210526314,9.329989552497864e-05,5,29
SoA heuristic,40,30,0.019230769230769232,3.220001235604286e-05,10,103
MMG,40,30,0.019230769230769232,0.00021350011229515076,10,103
SoA heuristic,100,75,0.007575757575757576,5.6499848142266273e-05,25,629
MMG,100,75,0.007575757575757576,0.000901699997484684,25,629
SoA heuristic,200,150,0.0037688442211055275,0.00010149995796382427,50,2514
MMG,200,150,0.0037688442211055275,0.002962500089779496,50,2514
SoA heuristic,400,300,0.0018796992481203006,0.0001906000543385744,100,10100
MMG,400,300,0.0018796992481203006,0.014255499932914972,100,10100
SoA heuristic,600,450,0.0012520868113522537,0.0002802999224513769,150,22486
MMG,600,450,0.0012520868113522537,0.029695999808609486,150,22486
SoA heuristic,1000,750,0.0007507507507507507,0.000560099957510829,250,62871
MMG,1000,750,0.0007507507507507507,0.12155300006270409,250,62871
SoA heuristic,2000,1500,0.00037518759379689845,0.0010912001598626375,500,249643
MMG,2000,1500,0.00037518759379689845,0.5273267000447959,500,249643
SoA heuristic,4000,3000,0.00018754688672168043,0.006750199943780899,1000,999299
MMG,4000,3000,0.00018754688672168043,1.8700438998639584,1000,999299
SoA heuristic,8000,6000,9.376172021502688e-05,0.0164425999391824,2000,3996731
MMG,8000,6000,9.376172021502688e-05,7.772657399997115,2000,3996731
SoA heuristic,20,15,0.039473684210526314,9.50999092310667e-05,5,17
MMG,20,15,0.039473684210526314,0.00029170000925660133,5,17
SoA heuristic,40,30,0.019230769230769232,8.080014958977699e-05,10,86
MMG,40,30,0.019230769230769232,0.0006103001069277525,10,86
SoA heuristic,100,75,0.007575757575757576,0.00010619987733662128,25,661
MMG,100,75,0.007575757575757576,0.0022495000157505274,25,661
SoA heuristic,200,150,0.0037688442211055275,0.0003158000763505697,50,2479
MMG,200,150,0.0037688442211055275,0.009215399855747819,50,2479
SoA heuristic,400,300,0.0018796992481203006,0.0006437001284211874,100,9918
MMG,400,300,0.0018796992481203006,0.01727140019647777,100,9918
SoA heuristic,600,450,0.0012520868113522537,0.00030419998802244663,150,22746
MMG,600,450,0.0012520868113522537,0.0365319000557065,150,22746
SoA heuristic,1000,750,0.0007507507507507507,0.0012799000833183527,250,62531
MMG,1000,750,0.0007507507507507507,0.12202239991165698,250,62531
SoA heuristic,2000,1500,0.00037518759379689845,0.0010365000925958157,500,250414
MMG,2000,1500,0.00037518759379689845,0.3360651999246329,500,250414
SoA heuristic,4000,3000,0.00018754688672168043,0.002844899892807007,1000,1000408
MMG,4000,3000,0.00018754688672168043,1.7201382000930607,1000,1000408
SoA heuristic,8000,6000,9.376172021502688e-05,0.014930000063031912,2000,4000974
MMG,8000,6000,9.376172021502688e-05,6.814246900146827,2000,4000974
SoA heuristic,20,15,0.039473684210526314,6.070011295378208e-05,5,38
MMG,20,15,0.039473684210526314,0.00026510003954172134,5,38
SoA heuristic,40,30,0.019230769230769232,8.070003241300583e-05,10,112
MMG,40,30,0.019230769230769232,0.0006059999577701092,10,112
SoA heuristic,100,75,0.007575757575757576,0.0001604999415576458,25,597
MMG,100,75,0.007575757575757576,0.002612000098451972,25,597
SoA heuristic,200,150,0.0037688442211055275,0.0002474000211805105,50,2509
MMG,200,150,0.0037688442211055275,0.005342300049960613,50,2509
SoA heuristic,400,300,0.0018796992481203006,0.00019659986719489098,100,9846
MMG,400,300,0.0018796992481203006,0.011236399877816439,100,9846
SoA heuristic,600,450,0.0012520868113522537,0.0007607000879943371,150,22491
MMG,600,450,0.0012520868113522537,0.03478759992867708,150,22491
SoA heuristic,1000,750,0.0007507507507507507,0.0006587000098079443,250,62509
MMG,1000,750,0.0007507507507507507,0.11082900012843311,250,62509
SoA heuristic,2000,1500,0.00037518759379689845,0.004355900222435594,500,249859
MMG,2000,1500,0.00037518759379689845,0.5057701000478119,500,249859
SoA heuristic,4000,3000,0.00018754688672168043,0.0021410000044852495,1000,1000106
MMG,4000,3000,0.00018754688672168043,1.8900539998430759,1000,1000106
SoA heuristic,8000,6000,9.376172021502688e-05,0.04586970014497638,2000,3999840
MMG,8000,6000,9.376172021502688e-05,7.422340099932626,2000,3999840
SoA heuristic,20,15,0.039473684210526314,6.600003689527512e-05,5,24
MMG,20,15,0.039473684210526314,0.00024489988572895527,5,24
SoA heuristic,40,30,0.019230769230769232,7.819989696145058e-05,10,105
MMG,40,30,0.019230769230769232,0.0004382999613881111,10,105
SoA heuristic,100,75,0.007575757575757576,0.00012910016812384129,25,666
MMG,100,75,0.007575757575757576,0.0011106000747531652,25,666
SoA heuristic,200,150,0.0037688442211055275,0.00010060006752610207,50,2548
MMG,200,150,0.0037688442211055275,0.00863309996202588,50,2548
SoA heuristic,400,300,0.0018796992481203006,0.0004593001212924719,100,9811
MMG,400,300,0.0018796992481203006,0.013244299916550517,100,9811
SoA heuristic,600,450,0.0012520868113522537,0.00028529996052384377,150,22407
MMG,600,450,0.0012520868113522537,0.03867250005714595,150,22407
SoA heuristic,1000,750,0.0007507507507507507,0.0006748000159859657,250,62392
MMG,1000,750,0.0007507507507507507,0.09360319981351495,250,62392
SoA heuristic,2000,1500,0.00037518759379689845,0.0013496000319719315,500,249827
MMG,2000,1500,0.00037518759379689845,0.3496423000469804,500,249827
SoA heuristic,4000,3000,0.00018754688672168043,0.0022067001555114985,1000,999970
MMG,4000,3000,0.00018754688672168043,1.7047310001216829,1000,999970
SoA heuristic,8000,6000,9.376172021502688e-05,0.005404299823567271,2000,4000082
MMG,8000,6000,9.376172021502688e-05,6.561505100224167,2000,4000082
SoA heuristic,20,15,0.039473684210526314,5.6399963796138763e-05,5,25
MMG,20,15,0.039473684210526314,0.00018740002997219563,5,25
SoA heuristic,40,30,0.019230769230769232,5.970010533928871e-05,10,84
MMG,40,30,0.019230769230769232,0.0004267999902367592,10,84
SoA heuristic,100,75,0.007575757575757576,7.609999738633633e-05,25,589
MMG,100,75,0.007575757575757576,0.001149199903011322,25,589
SoA heuristic,200,150,0.0037688442211055275,0.00010830000974237919,50,2537
MMG,200,150,0.0037688442211055275,0.004021200118586421,50,2537
SoA heuristic,400,300,0.0018796992481203006,0.0004151999019086361,100,10116
MMG,400,300,0.0018796992481203006,0.019541900139302015,100,10116
SoA heuristic,600,450,0.0012520868113522537,0.0008225999772548676,150,22559
MMG,600,450,0.0012520868113522537,0.046562200179323554,150,22559
SoA heuristic,1000,750,0.0007507507507507507,0.0013544999528676271,250,62719
MMG,1000,750,0.0007507507507507507,0.1107133999466896,250,62719
SoA heuristic,2000,1500,0.00037518759379689845,0.0028520000632852316,500,249725
MMG,2000,1500,0.00037518759379689845,0.5083029998932034,500,249725
SoA heuristic,4000,3000,0.00018754688672168043,0.03994669998064637,1000,999056
MMG,4000,3000,0.00018754688672168043,1.8616605999413878,1000,999056
SoA heuristic,8000,6000,9.376172021502688e-05,0.012272499967366457,2000,4000590
MMG,8000,6000,9.376172021502688e-05,6.826918300008401,2000,4000590
SoA heuristic,20,15,0.039473684210526314,7.239985279738903e-05,5,18
MMG,20,15,0.039473684210526314,0.0002771001309156418,5,18
SoA heuristic,40,30,0.019230769230769232,9.350012987852097e-05,10,100
MMG,40,30,0.019230769230769232,0.0007249999325722456,10,100
SoA heuristic,100,75,0.007575757575757576,0.00017949985340237617,25,633
MMG,100,75,0.007575757575757576,0.00278969993814826,25,633
SoA heuristic,200,150,0.0037688442211055275,0.00030559999868273735,50,2374
MMG,200,150,0.0037688442211055275,0.008717600023373961,50,2374
SoA heuristic,400,300,0.0018796992481203006,0.0005904999561607838,100,10049
MMG,400,300,0.0018796992481203006,0.0325271999463439,100,10049
SoA heuristic,600,450,0.0012520868113522537,0.0005956999957561493,150,22721
MMG,600,450,0.0012520868113522537,0.02522900002077222,150,22721
SoA heuristic,1000,750,0.0007507507507507507,0.0014967999886721373,250,62568
MMG,1000,750,0.0007507507507507507,0.1489454999100417,250,62568
SoA heuristic,2000,1500,0.00037518759379689845,0.0031254999339580536,500,250919
MMG,2000,1500,0.00037518759379689845,0.4741720000747591,500,250919
SoA heuristic,4000,3000,0.00018754688672168043,0.052571099950000644,1000,1000605
MMG,4000,3000,0.00018754688672168043,1.9235461000353098,1000,1000605
SoA heuristic,8000,6000,9.376172021502688e-05,0.006091399816796184,2000,4004048
MMG,8000,6000,9.376172021502688e-05,7.090735299978405,2000,4004048
SoA heuristic,20,15,0.039473684210526314,2.9499875381588936e-05,5,30
MMG,20,15,0.039473684210526314,9.360001422464848e-05,5,30
SoA heuristic,40,30,0.019230769230769232,3.1800009310245514e-05,10,103
MMG,40,30,0.019230769230769232,0.00029690004885196686,10,103
SoA heuristic,100,75,0.007575757575757576,6.059999577701092e-05,25,634
MMG,100,75,0.007575757575757576,0.0009001998696476221,25,634
SoA heuristic,200,150,0.0037688442211055275,0.00010400009341537952,50,2439
MMG,200,150,0.0037688442211055275,0.0032037999480962753,50,2439
SoA heuristic,400,300,0.0018796992481203006,0.00019560009241104126,100,10005
MMG,400,300,0.0018796992481203006,0.01798479980789125,100,10005
SoA heuristic,600,450,0.0012520868113522537,0.0008210001979023218,150,22623
MMG,600,450,0.0012520868113522537,0.05153049994260073,150,22623
SoA heuristic,1000,750,0.0007507507507507507,0.0013737000990658998,250,62700
MMG,1000,750,0.0007507507507507507,0.13281530002132058,250,62700
SoA heuristic,2000,1500,0.00037518759379689845,0.003660599933937192,500,249318
MMG,2000,1500,0.00037518759379689845,0.575898600043729,500,249318
SoA heuristic,4000,3000,0.00018754688672168043,0.007832200033590198,1000,1001453
MMG,4000,3000,0.00018754688672168043,1.7711954000405967,1000,1001453
SoA heuristic,8000,6000,9.376172021502688e-05,0.01381910010240972,2000,4000959
MMG,8000,6000,9.376172021502688e-05,6.99681459995918,2000,4000959
SoA heuristic,20,15,0.039473684210526314,2.8799986466765404e-05,5,22
MMG,20,15,0.039473684210526314,9.249988943338394e-05,5,22
SoA heuristic,40,30,0.019230769230769232,3.290013410151005e-05,10,99
MMG,40,30,0.019230769230769232,0.00021700002253055573,10,99
SoA heuristic,100,75,0.007575757575757576,5.7399971410632133e-05,25,653
MMG,100,75,0.007575757575757576,0.0009016001131385565,25,653
SoA heuristic,200,150,0.0037688442211055275,0.00012720003724098206,50,2501
MMG,200,150,0.0037688442211055275,0.003041099989786744,50,2501
SoA heuristic,400,300,0.0018796992481203006,0.00019910000264644623,100,10068
MMG,400,300,0.0018796992481203006,0.01973329996690154,100,10068
SoA heuristic,600,450,0.0012520868113522537,0.0006070001982152462,150,22490
MMG,600,450,0.0012520868113522537,0.03973069996573031,150,22490
SoA heuristic,1000,750,0.0007507507507507507,0.000568700022995472,250,62903
MMG,1000,750,0.0007507507507507507,0.083521599881351,250,62903
SoA heuristic,2000,1500,0.00037518759379689845,0.0011120999697595835,500,250731
MMG,2000,1500,0.00037518759379689845,0.38953719986602664,500,250731
SoA heuristic,4000,3000,0.00018754688672168043,0.0033161998726427555,1000,1001476
MMG,4000,3000,0.00018754688672168043,1.5590226000640541,1000,1001476
SoA heuristic,8000,6000,9.376172021502688e-05,0.005811800016090274,2000,4002534
MMG,8000,6000,9.376172021502688e-05,7.053783900104463,2000,4002534
SoA heuristic,20,15,0.039473684210526314,2.5999965146183968e-05,5,19
MMG,20,15,0.039473684210526314,8.990010246634483e-05,5,19
SoA heuristic,40,30,0.019230769230769232,3.0199997127056122e-05,10,104
MMG,40,30,0.019230769230769232,0.0002630001399666071,10,104
SoA heuristic,100,75,0.007575757575757576,0.00011270004324615002,25,646
MMG,100,75,0.007575757575757576,0.0013215001672506332,25,646
SoA heuristic,200,150,0.0037688442211055275,0.00012600002810359,50,2555
MMG,200,150,0.0037688442211055275,0.008209099993109703,50,2555
SoA heuristic,400,300,0.0018796992481203006,0.0001917998306453228,100,9931
MMG,400,300,0.0018796992481203006,0.0148779998999089,100,9931
SoA heuristic,600,450,0.0012520868113522537,0.0007903000805526972,150,22343
MMG,600,450,0.0012520868113522537,0.024352299980819225,150,22343
SoA heuristic,1000,750,0.0007507507507507507,0.0005383000243455172,250,62353
MMG,1000,750,0.0007507507507507507,0.14195399987511337,250,62353
SoA heuristic,2000,1500,0.00037518759379689845,0.0017375999595969915,500,250737
MMG,2000,1500,0.00037518759379689845,0.38323849998414516,500,250737
SoA heuristic,4000,3000,0.00018754688672168043,0.004582199966534972,1000,999746
MMG,4000,3000,0.00018754688672168043,1.808283699909225,1000,999746
SoA heuristic,8000,6000,9.376172021502688e-05,0.004559400025755167,2000,3996100
MMG,8000,6000,9.376172021502688e-05,7.372857399983332,2000,3996100
SoA heuristic,20,15,0.039473684210526314,3.060000017285347e-05,5,37
MMG,20,15,0.039473684210526314,0.00010169995948672295,5,37
SoA heuristic,40,30,0.019230769230769232,3.2499898225069046e-05,10,106
MMG,40,30,0.019230769230769232,0.00022130017168819904,10,106
SoA heuristic,100,75,0.007575757575757576,0.00010469998233020306,25,617
MMG,100,75,0.007575757575757576,0.0016528000123798847,25,617
SoA heuristic,200,150,0.0037688442211055275,0.00013609998859465122,50,2508
MMG,200,150,0.0037688442211055275,0.0035603998694568872,50,2508
SoA heuristic,400,300,0.0018796992481203006,0.00019480008631944656,100,9993
MMG,400,300,0.0018796992481203006,0.016784299863502383,100,9993
SoA heuristic,600,450,0.0012520868113522537,0.0008251999970525503,150,22666
MMG,600,450,0.0012520868113522537,0.06712739984504879,150,22666
SoA heuristic,1000,750,0.0007507507507507507,0.001689000055193901,250,62703
MMG,1000,750,0.0007507507507507507,0.17089910013601184,250,62703
SoA heuristic,2000,1500,0.00037518759379689845,0.0012954999692738056,500,250188
MMG,2000,1500,0.00037518759379689845,0.4502199999988079,500,250188
SoA heuristic,4000,3000,0.00018754688672168043,0.005071900086477399,1000,1001499
MMG,4000,3000,0.00018754688672168043,1.9711370000150055,1000,1001499
SoA heuristic,8000,6000,9.376172021502688e-05,0.019223199924454093,2000,4000617
MMG,8000,6000,9.376172021502688e-05,7.7701840999070555,2000,4000617
SoA heuristic,20,15,0.039473684210526314,2.9199989512562752e-05,5,24
MMG,20,15,0.039473684210526314,9.750016033649445e-05,5,24
SoA heuristic,40,30,0.019230769230769232,6.400002166628838e-05,10,108
MMG,40,30,0.019230769230769232,0.0002703999634832144,10,108
SoA heuristic,100,75,0.007575757575757576,5.579995922744274e-05,25,612
MMG,100,75,0.007575757575757576,0.0018285000696778297,25,612
SoA heuristic,200,150,0.0037688442211055275,0.00010000006295740604,50,2437
MMG,200,150,0.0037688442211055275,0.00520230014808476,50,2437
SoA heuristic,400,300,0.0018796992481203006,0.00021829991601407528,100,10212
MMG,400,300,0.0018796992481203006,0.01210019993595779,100,10212
SoA heuristic,600,450,0.0012520868113522537,0.0008363998495042324,150,22520
MMG,600,450,0.0012520868113522537,0.05285910004749894,150,22520
SoA heuristic,1000,750,0.0007507507507507507,0.0005416001658886671,250,62919
MMG,1000,750,0.0007507507507507507,0.13473360007628798,250,62919
SoA heuristic,2000,1500,0.00037518759379689845,0.0010458999313414097,500,249919
MMG,2000,1500,0.00037518759379689845,0.44917079992592335,500,249919
SoA heuristic,4000,3000,0.00018754688672168043,0.003046599915251136,1000,998184
MMG,4000,3000,0.00018754688672168043,1.6680638000834733,1000,998184
SoA heuristic,8000,6000,9.376172021502688e-05,0.005344599951058626,2000,4000142
MMG,8000,6000,9.376172021502688e-05,7.7016753000207245,2000,4000142
SoA heuristic,20,15,0.039473684210526314,2.7799978852272034e-05,5,28
MMG,20,15,0.039473684210526314,9.449990466237068e-05,5,28
SoA heuristic,40,30,0.019230769230769232,3.0199997127056122e-05,10,116
MMG,40,30,0.019230769230769232,0.00021440000273287296,10,116
SoA heuristic,100,75,0.007575757575757576,5.6900084018707275e-05,25,607
MMG,100,75,0.007575757575757576,0.0010637999512255192,25,607
SoA heuristic,200,150,0.0037688442211055275,0.00011700019240379333,50,2595
MMG,200,150,0.0037688442211055275,0.006437300005927682,50,2595
SoA heuristic,400,300,0.0018796992481203006,0.0005570000503212214,100,9908
MMG,400,300,0.0018796992481203006,0.022218500031158328,100,9908
SoA heuristic,600,450,0.0012520868113522537,0.0007984000258147717,150,22436
MMG,600,450,0.0012520868113522537,0.028031300054863095,150,22436
SoA heuristic,1000,750,0.0007507507507507507,0.0005300999619066715,250,62247
MMG,1000,750,0.0007507507507507507,0.07063820003531873,250,62247
SoA heuristic,2000,1500,0.00037518759379689845,0.0015774001367390156,500,249749
MMG,2000,1500,0.00037518759379689845,0.3840734001714736,500,249749
SoA heuristic,4000,3000,0.00018754688672168043,0.0022313001099973917,1000,1002047
MMG,4000,3000,0.00018754688672168043,1.7917828999925405,1000,1002047
SoA heuristic,8000,6000,9.376172021502688e-05,0.04418740002438426,2000,3997794
MMG,8000,6000,9.376172021502688e-05,7.636694800108671,2000,3997794
SoA heuristic,20,15,0.039473684210526314,7.129996083676815e-05,5,22
MMG,20,15,0.039473684210526314,0.00027689989656209946,5,22
SoA heuristic,40,30,0.019230769230769232,8.92002135515213e-05,10,93
MMG,40,30,0.019230769230769232,0.0006502999458462,10,93
SoA heuristic,100,75,0.007575757575757576,0.00016739987768232822,25,591
MMG,100,75,0.007575757575757576,0.002863100031390786,25,591
SoA heuristic,200,150,0.0037688442211055275,0.00029699993319809437,50,2467
MMG,200,150,0.0037688442211055275,0.008998700184747577,50,2467
SoA heuristic,400,300,0.0018796992481203006,0.0005680001340806484,100,10033
MMG,400,300,0.0018796992481203006,0.024681499926373363,100,10033
SoA heuristic,600,450,0.0012520868113522537,0.00034140003845095634,150,22454
MMG,600,450,0.0012520868113522537,0.04006849997676909,150,22454
SoA heuristic,1000,750,0.0007507507507507507,0.0006858000997453928,250,62310
MMG,1000,750,0.0007507507507507507,0.10030749998986721,250,62310
SoA heuristic,2000,1500,0.00037518759379689845,0.0010510999709367752,500,250720
MMG,2000,1500,0.00037518759379689845,0.4223228998016566,500,250720
SoA heuristic,4000,3000,0.00018754688672168043,0.006095800083130598,1000,1001134
MMG,4000,3000,0.00018754688672168043,1.8576694000512362,1000,1001134
SoA heuristic,8000,6000,9.376172021502688e-05,0.010606500087305903,2000,3996446
MMG,8000,6000,9.376172021502688e-05,7.20081129996106,2000,3996446
SoA heuristic,20,15,0.039473684210526314,6.200000643730164e-05,5,22
MMG,20,15,0.039473684210526314,0.0002937999088317156,5,22
SoA heuristic,40,30,0.019230769230769232,8.929986506700516e-05,10,87
MMG,40,30,0.019230769230769232,0.0006375000812113285,10,87
SoA heuristic,100,75,0.007575757575757576,0.00016870000399649143,25,604
MMG,100,75,0.007575757575757576,0.002736099995672703,25,604
SoA heuristic,200,150,0.0037688442211055275,0.0002549998462200165,50,2444
MMG,200,150,0.0037688442211055275,0.00701529998332262,50,2444
SoA heuristic,400,300,0.0018796992481203006,0.00019180006347596645,100,9921
MMG,400,300,0.0018796992481203006,0.02242870000191033,100,9921
SoA heuristic,600,450,0.0012520868113522537,0.0007968000136315823,150,22720
MMG,600,450,0.0012520868113522537,0.04548269999213517,150,22720
SoA heuristic,1000,750,0.0007507507507507507,0.0005298000760376453,250,62421
MMG,1000,750,0.0007507507507507507,0.1459772998932749,250,62421
SoA heuristic,2000,1500,0.00037518759379689845,0.003240399993956089,500,249355
MMG,2000,1500,0.00037518759379689845,0.4775430001318455,500,249355
SoA heuristic,4000,3000,0.00018754688672168043,0.006234300090000033,1000,997319
MMG,4000,3000,0.00018754688672168043,1.8104326000902802,1000,997319
SoA heuristic,8000,6000,9.376172021502688e-05,0.007280899910256267,2000,3997433
MMG,8000,6000,9.376172021502688e-05,7.644259799970314,2000,3997433
SoA heuristic,20,15,0.039473684210526314,4.549999721348286e-05,5,22
MMG,20,15,0.039473684210526314,0.00019120005890727043,5,22
SoA heuristic,40,30,0.019230769230769232,7.870001718401909e-05,10,101
MMG,40,30,0.019230769230769232,0.0004428999964147806,10,101
SoA heuristic,100,75,0.007575757575757576,8.360017091035843e-05,25,622
MMG,100,75,0.007575757575757576,0.0012360000982880592,25,622
SoA heuristic,200,150,0.0037688442211055275,0.00011060014367103577,50,2487
MMG,200,150,0.0037688442211055275,0.002978099975734949,50,2487
SoA heuristic,400,300,0.0018796992481203006,0.0001946000847965479,100,10149
MMG,400,300,0.0018796992481203006,0.01584160001948476,100,10149
SoA heuristic,600,450,0.0012520868113522537,0.0002802999224513769,150,22455
MMG,600,450,0.0012520868113522537,0.02504649991169572,150,22455
SoA heuristic,1000,750,0.0007507507507507507,0.0005793001037091017,250,62532
MMG,1000,750,0.0007507507507507507,0.1521501000970602,250,62532
SoA heuristic,2000,1500,0.00037518759379689845,0.0031454998534172773,500,250641
MMG,2000,1500,0.00037518759379689845,0.4824920000974089,500,250641
SoA heuristic,4000,3000,0.00018754688672168043,0.028761199908331037,1000,1000057
MMG,4000,3000,0.00018754688672168043,1.8228684000205249,1000,1000057
SoA heuristic,8000,6000,9.376172021502688e-05,0.012301600072532892,2000,4000092
MMG,8000,6000,9.376172021502688e-05,7.919533300213516,2000,4000092
SoA heuristic,20,15,0.039473684210526314,2.759997732937336e-05,5,17
MMG,20,15,0.039473684210526314,9.569991379976273e-05,5,17
SoA heuristic,40,30,0.019230769230769232,3.1400006264448166e-05,10,111
MMG,40,30,0.019230769230769232,0.0002125999890267849,10,111
SoA heuristic,100,75,0.007575757575757576,5.779997445642948e-05,25,639
MMG,100,75,0.007575757575757576,0.0008739999029785395,25,639
SoA heuristic,200,150,0.0037688442211055275,0.00010200007818639278,50,2476
MMG,200,150,0.0037688442211055275,0.003024600213393569,50,2476
SoA heuristic,400,300,0.0018796992481203006,0.0005570999346673489,100,9836
MMG,400,300,0.0018796992481203006,0.03293159999884665,100,9836
SoA heuristic,600,450,0.0012520868113522537,0.0005608999636024237,150,22630
MMG,600,450,0.0012520868113522537,0.07025970006361604,150,22630
SoA heuristic,1000,750,0.0007507507507507507,0.0009312999900430441,250,62326
MMG,1000,750,0.0007507507507507507,0.10671110008843243,250,62326
SoA heuristic,2000,1500,0.00037518759379689845,0.0015174997970461845,500,249904
MMG,2000,1500,0.00037518759379689845,0.3850924000144005,500,249904
SoA heuristic,4000,3000,0.00018754688672168043,0.002316799946129322,1000,1000274
MMG,4000,3000,0.00018754688672168043,1.7611936000175774,1000,1000274
SoA heuristic,8000,6000,9.376172021502688e-05,0.005849899956956506,2000,4002086
MMG,8000,6000,9.376172021502688e-05,7.255468299845234,2000,4002086
SoA heuristic,20,15,0.039473684210526314,2.7899863198399544e-05,5,28
MMG,20,15,0.039473684210526314,9.289989247918129e-05,5,28
SoA heuristic,40,30,0.019230769230769232,9.620003402233124e-05,10,96
MMG,40,30,0.019230769230769232,0.0006798000540584326,10,96
SoA heuristic,100,75,0.007575757575757576,0.0001762998290359974,25,623
MMG,100,75,0.007575757575757576,0.0020660001318901777,25,623
SoA heuristic,200,150,0.0037688442211055275,0.00010940013453364372,50,2487
MMG,200,150,0.0037688442211055275,0.008501400006935,50,2487
SoA heuristic,400,300,0.0018796992481203006,0.0006041999440640211,100,9919
MMG,400,300,0.0018796992481203006,0.024110000114887953,100,9919
SoA heuristic,600,450,0.0012520868113522537,0.0009075000416487455,150,22286
MMG,600,450,0.0012520868113522537,0.06265889992937446,150,22286
SoA heuristic,1000,750,0.0007507507507507507,0.001141900196671486,250,62309
MMG,1000,750,0.0007507507507507507,0.14213449996896088,250,62309
SoA heuristic,2000,1500,0.00037518759379689845,0.0016828998923301697,500,250640
MMG,2000,1500,0.00037518759379689845,0.4503990998491645,500,250640
SoA heuristic,4000,3000,0.00018754688672168043,0.0022273000795394182,1000,999789
MMG,4000,3000,0.00018754688672168043,1.8527736999094486,1000,999789
SoA heuristic,8000,6000,9.376172021502688e-05,0.004896000027656555,2000,3999677
MMG,8000,6000,9.376172021502688e-05,7.234366899821907,2000,3999677
SoA heuristic,20,15,0.039473684210526314,7.039983756840229e-05,5,23
MMG,20,15,0.039473684210526314,0.0002641999162733555,5,23
SoA heuristic,40,30,0.019230769230769232,9.240000508725643e-05,10,88
MMG,40,30,0.019230769230769232,0.0006959999445825815,10,88
SoA heuristic,100,75,0.007575757575757576,0.00017569982446730137,25,565
MMG,100,75,0.007575757575757576,0.0027572999242693186,25,565
SoA heuristic,200,150,0.0037688442211055275,0.0003011999651789665,50,2469
MMG,200,150,0.0037688442211055275,0.00665120012126863,50,2469
SoA heuristic,400,300,0.0018796992481203006,0.000564799876883626,100,10105
MMG,400,300,0.0018796992481203006,0.02779059996828437,100,10105
SoA heuristic,600,450,0.0012520868113522537,0.0008928000461310148,150,22608
MMG,600,450,0.0012520868113522537,0.06149260001257062,150,22608
SoA heuristic,1000,750,0.0007507507507507507,0.0010746000334620476,250,62313
MMG,1000,750,0.0007507507507507507,0.12356569990515709,250,62313
SoA heuristic,2000,1500,0.00037518759379689845,0.0021733001340180635,500,250058
MMG,2000,1500,0.00037518759379689845,0.45848509995266795,500,250058
SoA heuristic,4000,3000,0.00018754688672168043,0.005089899990707636,1000,1001082
MMG,4000,3000,0.00018754688672168043,1.7612103999126703,1000,1001082
SoA heuristic,8000,6000,9.376172021502688e-05,0.014066100120544434,2000,4002204
MMG,8000,6000,9.376172021502688e-05,7.444917100016028,2000,4002204
SoA heuristic,20,15,0.039473684210526314,7.160007953643799e-05,5,23
MMG,20,15,0.039473684210526314,0.00029170000925660133,5,23
SoA heuristic,40,30,0.019230769230769232,8.649984374642372e-05,10,110
MMG,40,30,0.019230769230769232,0.0006593000143766403,10,110
SoA heuristic,100,75,0.007575757575757576,0.00018190010450780392,25,634
MMG,100,75,0.007575757575757576,0.0018106999341398478,25,634
SoA heuristic,200,150,0.0037688442211055275,0.00030940002761781216,50,2510
MMG,200,150,0.0037688442211055275,0.008324800059199333,50,2510
SoA heuristic,400,300,0.0018796992481203006,0.0005918999668210745,100,9913
MMG,400,300,0.0018796992481203006,0.02562259999103844,100,9913
SoA heuristic,600,450,0.0012520868113522537,0.000883100088685751,150,22624
MMG,600,450,0.0012520868113522537,0.0396030000410974,150,22624
SoA heuristic,1000,750,0.0007507507507507507,0.000970400171354413,250,62691
MMG,1000,750,0.0007507507507507507,0.11211580014787614,250,62691
SoA heuristic,2000,1500,0.00037518759379689845,0.003038200084120035,500,249808
MMG,2000,1500,0.00037518759379689845,0.43032649997621775,500,249808
SoA heuristic,4000,3000,0.00018754688672168043,0.00217599980533123,1000,998771
MMG,4000,3000,0.00018754688672168043,1.6974039999768138,1000,998771
SoA heuristic,8000,6000,9.376172021502688e-05,0.013714100001379848,2000,3999440
MMG,8000,6000,9.376172021502688e-05,7.306709999917075,2000,3999440
SoA heuristic,20,15,0.039473684210526314,6.640003994107246e-05,5,25
MMG,20,15,0.039473684210526314,0.00027529988437891006,5,25
SoA heuristic,40,30,0.019230769230769232,3.309990279376507e-05,10,84
MMG,40,30,0.019230769230769232,0.00021680002100765705,10,84
SoA heuristic,100,75,0.007575757575757576,6.240000948309898e-05,25,618
MMG,100,75,0.007575757575757576,0.0009280000813305378,25,618
SoA heuristic,200,150,0.0037688442211055275,0.0004991998430341482,50,2516
MMG,200,150,0.0037688442211055275,0.004161400021985173,50,2516
SoA heuristic,400,300,0.0018796992481203006,0.0004352000541985035,100,10062
MMG,400,300,0.0018796992481203006,0.02122710016556084,100,10062
SoA heuristic,600,450,0.0012520868113522537,0.0005129000637680292,150,22484
MMG,600,450,0.0012520868113522537,0.02776509989053011,150,22484
SoA heuristic,1000,750,0.0007507507507507507,0.0009658001363277435,250,62625
MMG,1000,750,0.0007507507507507507,0.0861871000379324,250,62625
SoA heuristic,2000,1500,0.00037518759379689845,0.0013027999084442854,500,249253
MMG,2000,1500,0.00037518759379689845,0.31981520005501807,500,249253
SoA heuristic,4000,3000,0.00018754688672168043,0.0025953000877052546,1000,1000669
MMG,4000,3000,0.00018754688672168043,1.6831877999939024,1000,1000669
SoA heuristic,8000,6000,9.376172021502688e-05,0.009065099991858006,2000,4001247
MMG,8000,6000,9.376172021502688e-05,7.111558199860156,2000,4001247
SoA heuristic,20,15,0.039473684210526314,2.759997732937336e-05,5,27
MMG,20,15,0.039473684210526314,9.450013749301434e-05,5,27
SoA heuristic,40,30,0.019230769230769232,3.229989670217037e-05,10,120
MMG,40,30,0.019230769230769232,0.00021039997227489948,10,120
SoA heuristic,100,75,0.007575757575757576,5.7399971410632133e-05,25,599
MMG,100,75,0.007575757575757576,0.0008924000430852175,25,599
SoA heuristic,200,150,0.0037688442211055275,0.0001012999564409256,50,2491
MMG,200,150,0.0037688442211055275,0.004135099938139319,50,2491
SoA heuristic,400,300,0.0018796992481203006,0.0001917998306453228,100,9950
MMG,400,300,0.0018796992481203006,0.011823400156572461,100,9950
SoA heuristic,600,450,0.0012520868113522537,0.0002929000183939934,150,22638
MMG,600,450,0.0012520868113522537,0.05079360003583133,150,22638
SoA heuristic,1000,750,0.0007507507507507507,0.0010560001246631145,250,62499
MMG,1000,750,0.0007507507507507507,0.09947179979644716,250,62499
SoA heuristic,2000,1500,0.00037518759379689845,0.003843100043013692,500,250152
MMG,2000,1500,0.00037518759379689845,0.5596961998380721,500,250152
SoA heuristic,4000,3000,0.00018754688672168043,0.002515600062906742,1000,1001183
MMG,4000,3000,0.00018754688672168043,1.9241137001663446,1000,1001183
SoA heuristic,8000,6000,9.376172021502688e-05,0.01028240006417036,2000,4001750
MMG,8000,6000,9.376172021502688e-05,7.1730979001149535,2000,4001750
SoA heuristic,20,15,0.039473684210526314,3.360002301633358e-05,5,30
MMG,20,15,0.039473684210526314,0.00011239992454648018,5,30
SoA heuristic,40,30,0.019230769230769232,4.229997284710407e-05,10,118
MMG,40,30,0.019230769230769232,0.0002941000275313854,10,118
SoA heuristic,100,75,0.007575757575757576,8.9599983766675e-05,25,595
MMG,100,75,0.007575757575757576,0.0012492998503148556,25,595
SoA heuristic,200,150,0.0037688442211055275,0.00013520009815692902,50,2539
MMG,200,150,0.0037688442211055275,0.005428300006315112,50,2539
SoA heuristic,400,300,0.0018796992481203006,0.00023630005307495594,100,9931
MMG,400,300,0.0018796992481203006,0.01465449994429946,100,9931
SoA heuristic,600,450,0.0012520868113522537,0.00041680014692246914,150,22478
MMG,600,450,0.0012520868113522537,0.03560309996828437,150,22478
SoA heuristic,1000,750,0.0007507507507507507,0.0007124999538064003,250,62531
MMG,1000,750,0.0007507507507507507,0.0841439999639988,250,62531
SoA heuristic,2000,1500,0.00037518759379689845,0.0013086998369544744,500,249459
MMG,2000,1500,0.00037518759379689845,0.3412785998079926,500,249459
SoA heuristic,4000,3000,0.00018754688672168043,0.0032454999163746834,1000,1000327
MMG,4000,3000,0.00018754688672168043,1.6138363999780267,1000,1000327
SoA heuristic,8000,6000,9.376172021502688e-05,0.0053732001688331366,2000,3999863
MMG,8000,6000,9.376172021502688e-05,6.0733180998358876,2000,3999863
SoA heuristic,20,15,0.039473684210526314,5.8900099247694016e-05,5,19
MMG,20,15,0.039473684210526314,0.00024359999224543571,5,19
SoA heuristic,40,30,0.019230769230769232,8.859997615218163e-05,10,93
MMG,40,30,0.019230769230769232,0.000749099999666214,10,93
SoA heuristic,100,75,0.007575757575757576,0.00022389995865523815,25,580
MMG,100,75,0.007575757575757576,0.002039100043475628,25,580
SoA heuristic,200,150,0.0037688442211055275,0.00011139991693198681,50,2583
MMG,200,150,0.0037688442211055275,0.006746700033545494,50,2583
SoA heuristic,400,300,0.0018796992481203006,0.00041239988058805466,100,10037
MMG,400,300,0.0018796992481203006,0.015595100121572614,100,10037
SoA heuristic,600,450,0.0012520868113522537,0.00031020003370940685,150,22482
MMG,600,450,0.0012520868113522537,0.03397900005802512,150,22482
SoA heuristic,1000,750,0.0007507507507507507,0.001073900144547224,250,62401
MMG,1000,750,0.0007507507507507507,0.1024863999336958,250,62401
SoA heuristic,2000,1500,0.00037518759379689845,0.002327699912711978,500,249790
MMG,2000,1500,0.00037518759379689845,0.45118710002861917,500,249790
SoA heuristic,4000,3000,0.00018754688672168043,0.002844100119546056,1000,1001234
MMG,4000,3000,0.00018754688672168043,1.5565212999936193,1000,1001234
SoA heuristic,8000,6000,9.376172021502688e-05,0.0056541000958532095,2000,3999299
MMG,8000,6000,9.376172021502688e-05,6.0923754998948425,2000,3999299
SoA heuristic,20,15,0.039473684210526314,7.679988630115986e-05,5,24
MMG,20,15,0.039473684210526314,0.00029159989207983017,5,24
SoA heuristic,40,30,0.019230769230769232,0.00010029994882643223,10,92
MMG,40,30,0.019230769230769232,0.0007060000207275152,10,92
SoA heuristic,100,75,0.007575757575757576,0.0001884999219328165,25,629
MMG,100,75,0.007575757575757576,0.002926599932834506,25,629
SoA heuristic,200,150,0.0037688442211055275,0.0003347999881953001,50,2521
MMG,200,150,0.0037688442211055275,0.010156200034543872,50,2521
SoA heuristic,400,300,0.0018796992481203006,0.0006592997815459967,100,10123
MMG,400,300,0.0018796992481203006,0.03666110010817647,100,10123
SoA heuristic,600,450,0.0012520868113522537,0.0009174000006169081,150,22464
MMG,600,450,0.0012520868113522537,0.08280500001274049,150,22464
SoA heuristic,1000,750,0.0007507507507507507,0.002026899950578809,250,62322
MMG,1000,750,0.0007507507507507507,0.22234690003097057,250,62322
SoA heuristic,2000,1500,0.00037518759379689845,0.003554200055077672,500,250382
MMG,2000,1500,0.00037518759379689845,0.906031500082463,500,250382
SoA heuristic,4000,3000,0.00018754688672168043,0.0071807000786066055,1000,1000746
MMG,4000,3000,0.00018754688672168043,3.6228401998523623,1000,1000746
SoA heuristic,8000,6000,9.376172021502688e-05,0.01696279994212091,2000,4002647
MMG,8000,6000,9.376172021502688e-05,14.993931300006807,2000,4002647
SoA heuristic,20,15,0.039473684210526314,7.509998977184296e-05,5,27
MMG,20,15,0.039473684210526314,0.00030049984343349934,5,27
SoA heuristic,40,30,0.019230769230769232,9.949994273483753e-05,10,113
MMG,40,30,0.019230769230769232,0.0008471999317407608,10,113
SoA heuristic,100,75,0.007575757575757576,0.00018579978495836258,25,644
MMG,100,75,0.007575757575757576,0.0028950998093932867,25,644
SoA heuristic,200,150,0.0037688442211055275,0.0003260001540184021,50,2475
MMG,200,150,0.0037688442211055275,0.010162300197407603,50,2475
SoA heuristic,400,300,0.0018796992481203006,0.0007771998643875122,100,10088
MMG,400,300,0.0018796992481203006,0.03710249997675419,100,10088
SoA heuristic,600,450,0.0012520868113522537,0.001001899829134345,150,22440
MMG,600,450,0.0012520868113522537,0.08102459996007383,150,22440
SoA heuristic,1000,750,0.0007507507507507507,0.0017540999688208103,250,62466
MMG,1000,750,0.0007507507507507507,0.21982050011865795,250,62466
SoA heuristic,2000,1500,0.00037518759379689845,0.003820100100710988,500,249735
MMG,2000,1500,0.00037518759379689845,0.8763167001307011,500,249735
SoA heuristic,4000,3000,0.00018754688672168043,0.0070933999959379435,1000,999296
MMG,4000,3000,0.00018754688672168043,3.665505399927497,1000,999296
SoA heuristic,8000,6000,9.376172021502688e-05,0.01772450003772974,2000,3999799
MMG,8000,6000,9.376172021502688e-05,15.481527399970219,2000,3999799
SoA heuristic,20,15,0.039473684210526314,3.509991802275181e-05,5,25
MMG,20,15,0.039473684210526314,0.00010270019993185997,5,25
SoA heuristic,40,30,0.019230769230769232,4.259985871613026e-05,10,87
MMG,40,30,0.019230769230769232,0.00022699986584484577,10,87
SoA heuristic,100,75,0.007575757575757576,6.240000948309898e-05,25,627
MMG,100,75,0.007575757575757576,0.0009820000268518925,25,627
SoA heuristic,200,150,0.0037688442211055275,0.00011110003106296062,50,2503
MMG,200,150,0.0037688442211055275,0.003283199854195118,50,2503
SoA heuristic,400,300,0.0018796992481203006,0.00023310002870857716,100,9933
MMG,400,300,0.0018796992481203006,0.012123200111091137,100,9933
SoA heuristic,600,450,0.0012520868113522537,0.0003462000750005245,150,22315
MMG,600,450,0.0012520868113522537,0.026779700070619583,150,22315
SoA heuristic,1000,750,0.0007507507507507507,0.0006767997983843088,250,62374
MMG,1000,750,0.0007507507507507507,0.0752134001813829,250,62374
SoA heuristic,2000,1500,0.00037518759379689845,0.001258700154721737,500,249895
MMG,2000,1500,0.00037518759379689845,0.29349790001288056,500,249895
SoA heuristic,4000,3000,0.00018754688672168043,0.002449899911880493,1000,1001104
MMG,4000,3000,0.00018754688672168043,1.2001163999084383,1000,1001104
SoA heuristic,8000,6000,9.376172021502688e-05,0.005147299962118268,2000,4004934
MMG,8000,6000,9.376172021502688e-05,4.840969800017774,2000,4004934
SoA heuristic,20,15,0.039473684210526314,7.449998520314693e-05,5,19
MMG,20,15,0.039473684210526314,0.00017070001922547817,5,19
SoA heuristic,40,30,0.019230769230769232,6.779981777071953e-05,10,103
MMG,40,30,0.019230769230769232,0.0004237999673932791,10,103
SoA heuristic,100,75,0.007575757575757576,0.0001672001089900732,25,632
MMG,100,75,0.007575757575757576,0.0016898999456316233,25,632
SoA heuristic,200,150,0.0037688442211055275,0.0001308999489992857,50,2525
MMG,200,150,0.0037688442211055275,0.0038308000657707453,50,2525
SoA heuristic,400,300,0.0018796992481203006,0.00024339999072253704,100,9991
MMG,400,300,0.0018796992481203006,0.014785400126129389,100,9991
SoA heuristic,600,450,0.0012520868113522537,0.000462499912828207,150,22347
MMG,600,450,0.0012520868113522537,0.02850429993122816,150,22347
SoA heuristic,1000,750,0.0007507507507507507,0.0006466000340878963,250,62358
MMG,1000,750,0.0007507507507507507,0.07483229995705187,250,62358
SoA heuristic,2000,1500,0.00037518759379689845,0.001145099988207221,500,250495
MMG,2000,1500,0.00037518759379689845,0.29846950015053153,500,250495
SoA heuristic,4000,3000,0.00018754688672168043,0.0033294998575001955,1000,998664
MMG,4000,3000,0.00018754688672168043,1.1496105999685824,1000,998664
SoA heuristic,8000,6000,9.376172021502688e-05,0.0059310998767614365,2000,4001595
MMG,8000,6000,9.376172021502688e-05,4.856123799923807,2000,4001595
SoA heuristic,20,15,0.039473684210526314,2.950010821223259e-05,5,30
MMG,20,15,0.039473684210526314,9.91998240351677e-05,5,30
SoA heuristic,40,30,0.019230769230769232,3.5300152376294136e-05,10,110
MMG,40,30,0.019230769230769232,0.0002313000150024891,10,110
SoA heuristic,100,75,0.007575757575757576,6.0499878600239754e-05,25,629
MMG,100,75,0.007575757575757576,0.0009234999306499958,25,629
SoA heuristic,200,150,0.0037688442211055275,0.00010850001126527786,50,2496
MMG,200,150,0.0037688442211055275,0.003161099972203374,50,2496
SoA heuristic,400,300,0.0018796992481203006,0.0002079999540001154,100,10080
MMG,400,300,0.0018796992481203006,0.011911100009456277,100,10080
SoA heuristic,600,450,0.0012520868113522537,0.0003084000200033188,150,22589
MMG,600,450,0.0012520868113522537,0.026853500166907907,150,22589
SoA heuristic,1000,750,0.0007507507507507507,0.0005894000642001629,250,62336
MMG,1000,750,0.0007507507507507507,0.07302809995599091,250,62336
SoA heuristic,2000,1500,0.00037518759379689845,0.0015396999660879374,500,250368
MMG,2000,1500,0.00037518759379689845,0.304704399779439,500,250368
SoA heuristic,4000,3000,0.00018754688672168043,0.003001200035214424,1000,998579
MMG,4000,3000,0.00018754688672168043,1.2025323000270873,1000,998579
SoA heuristic,8000,6000,9.376172021502688e-05,0.005172699922695756,2000,3999948
MMG,8000,6000,9.376172021502688e-05,4.8898988999426365,2000,3999948
SoA heuristic,20,15,0.039473684210526314,2.9199989512562752e-05,5,20
MMG,20,15,0.039473684210526314,9.950017556548119e-05,5,20
SoA heuristic,40,30,0.019230769230769232,3.5300152376294136e-05,10,97
MMG,40,30,0.019230769230769232,0.00023369980044662952,10,97
SoA heuristic,100,75,0.007575757575757576,6.019999273121357e-05,25,657
MMG,100,75,0.007575757575757576,0.0009443999733775854,25,657
SoA heuristic,200,150,0.0037688442211055275,0.00010870001278817654,50,2541
MMG,200,150,0.0037688442211055275,0.0032247998751699924,50,2541
SoA heuristic,400,300,0.0018796992481203006,0.00021359999664127827,100,9890
MMG,400,300,0.0018796992481203006,0.012103999964892864,100,9890
SoA heuristic,600,450,0.0012520868113522537,0.00032029999420046806,150,22428
MMG,600,450,0.0012520868113522537,0.026862199883908033,150,22428
SoA heuristic,1000,750,0.0007507507507507507,0.0006558999884873629,250,62404
MMG,1000,750,0.0007507507507507507,0.07339719985611737,250,62404
SoA heuristic,2000,1500,0.00037518759379689845,0.001416799845173955,500,249227
MMG,2000,1500,0.00037518759379689845,0.29981810017488897,500,249227
SoA heuristic,4000,3000,0.00018754688672168043,0.0031677999068051577,1000,1000170
MMG,4000,3000,0.00018754688672168043,1.161369200097397,1000,1000170
SoA heuristic,8000,6000,9.376172021502688e-05,0.004883200163021684,2000,4000782
MMG,8000,6000,9.376172021502688e-05,4.887760600075126,2000,4000782
SoA heuristic,20,15,0.039473684210526314,3.6800047382712364e-05,5,27
MMG,20,15,0.039473684210526314,0.0001017001923173666,5,27
SoA heuristic,40,30,0.019230769230769232,3.6499928683042526e-05,10,103
MMG,40,30,0.019230769230769232,0.00023450003936886787,10,103
SoA heuristic,100,75,0.007575757575757576,6.340001709759235e-05,25,630
MMG,100,75,0.007575757575757576,0.0009692998137325048,25,630
SoA heuristic,200,150,0.0037688442211055275,0.00013589998707175255,50,2465
MMG,200,150,0.0037688442211055275,0.003364000003784895,50,2465
SoA heuristic,400,300,0.0018796992481203006,0.0003076000139117241,100,9959
MMG,400,300,0.0018796992481203006,0.01333600003272295,100,9959
SoA heuristic,600,450,0.0012520868113522537,0.000340400030836463,150,22534
MMG,600,450,0.0012520868113522537,0.025601800065487623,150,22534
SoA heuristic,1000,750,0.0007507507507507507,0.0005932999774813652,250,62003
MMG,1000,750,0.0007507507507507507,0.07384069985710084,250,62003
SoA heuristic,2000,1500,0.00037518759379689845,0.001223500119522214,500,249771
MMG,2000,1500,0.00037518759379689845,0.29536769981496036,500,249771
SoA heuristic,4000,3000,0.00018754688672168043,0.0028701999690383673,1000,1001076
MMG,4000,3000,0.00018754688672168043,1.1554209999740124,1000,1001076
SoA heuristic,8000,6000,9.376172021502688e-05,0.005676500033587217,2000,4001371
MMG,8000,6000,9.376172021502688e-05,4.7076659998856485,2000,4001371
SoA heuristic,20,15,0.039473684210526314,3.600004129111767e-05,5,23
MMG,20,15,0.039473684210526314,0.00011280016042292118,5,23
SoA heuristic,40,30,0.019230769230769232,4.529999569058418e-05,10,114
MMG,40,30,0.019230769230769232,0.0003525000065565109,10,114
SoA heuristic,100,75,0.007575757575757576,7.780012674629688e-05,25,660
MMG,100,75,0.007575757575757576,0.0009913998655974865,25,660
SoA heuristic,200,150,0.0037688442211055275,0.00021450011990964413,50,2432
MMG,200,150,0.0037688442211055275,0.003472799900919199,50,2432
SoA heuristic,400,300,0.0018796992481203006,0.0003474999684840441,100,9858
MMG,400,300,0.0018796992481203006,0.012273200089111924,100,9858
SoA heuristic,600,450,0.0012520868113522537,0.00036150007508695126,150,22348
MMG,600,450,0.0012520868113522537,0.027387900045141578,150,22348
SoA heuristic,1000,750,0.0007507507507507507,0.0006305999122560024,250,62728
MMG,1000,750,0.0007507507507507507,0.079476100159809,250,62728
SoA heuristic,2000,1500,0.00037518759379689845,0.00172149995341897,500,250132
MMG,2000,1500,0.00037518759379689845,0.30269329994916916,500,250132
SoA heuristic,4000,3000,0.00018754688672168043,0.0031114998273551464,1000,1000122
MMG,4000,3000,0.00018754688672168043,1.2110686001833528,1000,1000122
SoA heuristic,8000,6000,9.376172021502688e-05,0.005972899962216616,2000,4001524
MMG,8000,6000,9.376172021502688e-05,4.8604530999436975,2000,4001524
SoA heuristic,20,15,0.039473684210526314,5.249981768429279e-05,5,23
MMG,20,15,0.039473684210526314,0.00010130018927156925,5,23
SoA heuristic,40,30,0.019230769230769232,3.400002606213093e-05,10,104
MMG,40,30,0.019230769230769232,0.00022029993124306202,10,104
SoA heuristic,100,75,0.007575757575757576,5.979998968541622e-05,25,647
MMG,100,75,0.007575757575757576,0.0009287998545914888,25,647
SoA heuristic,200,150,0.0037688442211055275,0.00011230004020035267,50,2516
MMG,200,150,0.0037688442211055275,0.0032876001205295324,50,2516
SoA heuristic,400,300,0.0018796992481203006,0.00020689982920885086,100,9985
MMG,400,300,0.0018796992481203006,0.012005599914118648,100,9985
SoA heuristic,600,450,0.0012520868113522537,0.0003198999911546707,150,22300
MMG,600,450,0.0012520868113522537,0.026921199867501855,150,22300
SoA heuristic,1000,750,0.0007507507507507507,0.0006492999382317066,250,62431
MMG,1000,750,0.0007507507507507507,0.07211759989149868,250,62431
SoA heuristic,2000,1500,0.00037518759379689845,0.0014076000079512596,500,249793
MMG,2000,1500,0.00037518759379689845,0.28850969998165965,500,249793
SoA heuristic,4000,3000,0.00018754688672168043,0.0029390999116003513,1000,1001205
MMG,4000,3000,0.00018754688672168043,1.1759748000185937,1000,1001205
SoA heuristic,8000,6000,9.376172021502688e-05,0.005753800040110946,2000,4002918
MMG,8000,6000,9.376172021502688e-05,4.86477499990724,2000,4002918
SoA heuristic,20,15,0.039473684210526314,3.769993782043457e-05,5,19
MMG,20,15,0.039473684210526314,0.00012880004942417145,5,19
SoA heuristic,40,30,0.019230769230769232,4.540011286735535e-05,10,97
MMG,40,30,0.019230769230769232,0.0003504999913275242,10,97
SoA heuristic,100,75,0.007575757575757576,8.179992437362671e-05,25,639
MMG,100,75,0.007575757575757576,0.0012240000069141388,25,639
SoA heuristic,200,150,0.0037688442211055275,0.00014089979231357574,50,2486
MMG,200,150,0.0037688442211055275,0.003180600004270673,50,2486
SoA heuristic,400,300,0.0018796992481203006,0.000193099956959486,100,10083
MMG,400,300,0.0018796992481203006,0.010926999850198627,100,10083
SoA heuristic,600,450,0.0012520868113522537,0.00029540015384554863,150,22583
MMG,600,450,0.0012520868113522537,0.025797000154852867,150,22583
SoA heuristic,1000,750,0.0007507507507507507,0.0005953998770564795,250,62292
MMG,1000,750,0.0007507507507507507,0.07144710002467036,250,62292
SoA heuristic,2000,1500,0.00037518759379689845,0.0011367001570761204,500,251228
MMG,2000,1500,0.00037518759379689845,0.2952752001583576,500,251228
SoA heuristic,4000,3000,0.00018754688672168043,0.02983510005287826,1000,1000388
MMG,4000,3000,0.00018754688672168043,1.1347511999774724,1000,1000388
SoA heuristic,8000,6000,9.376172021502688e-05,0.00583630008623004,2000,3999860
MMG,8000,6000,9.376172021502688e-05,4.707507899962366,2000,3999860
SoA heuristic,20,15,0.039473684210526314,5.779997445642948e-05,5,27
MMG,20,15,0.039473684210526314,0.00015069986693561077,5,27
SoA heuristic,40,30,0.019230769230769232,5.469983443617821e-05,10,94
MMG,40,30,0.019230769230769232,0.00028529996052384377,10,94
SoA heuristic,100,75,0.007575757575757576,0.00013299984857439995,25,638
MMG,100,75,0.007575757575757576,0.0015489999204874039,25,638
SoA heuristic,200,150,0.0037688442211055275,0.00018209987320005894,50,2526
MMG,200,150,0.0037688442211055275,0.0033308998681604862,50,2526
SoA heuristic,400,300,0.0018796992481203006,0.000345699954777956,100,10213
MMG,400,300,0.0018796992481203006,0.012891900027170777,100,10213
SoA heuristic,600,450,0.0012520868113522537,0.0003955999854952097,150,22585
MMG,600,450,0.0012520868113522537,0.026814299868419766,150,22585
SoA heuristic,1000,750,0.0007507507507507507,0.0007116999477148056,250,62563
MMG,1000,750,0.0007507507507507507,0.07443080004304647,250,62563
SoA heuristic,2000,1500,0.00037518759379689845,0.001165800029411912,500,249550
MMG,2000,1500,0.00037518759379689845,0.29298419994302094,500,249550
SoA heuristic,4000,3000,0.00018754688672168043,0.002640899969264865,1000,999652
MMG,4000,3000,0.00018754688672168043,1.2101672000717372,1000,999652
SoA heuristic,8000,6000,9.376172021502688e-05,0.005130300065502524,2000,4001616
MMG,8000,6000,9.376172021502688e-05,4.9372483000624925,2000,4001616
SoA heuristic,20,15,0.039473684210526314,3.2800016924738884e-05,5,21
MMG,20,15,0.039473684210526314,0.00012110010720789433,5,21
SoA heuristic,40,30,0.019230769230769232,7.529999129474163e-05,10,101
MMG,40,30,0.019230769230769232,0.0002816000487655401,10,101
SoA heuristic,100,75,0.007575757575757576,8.099991828203201e-05,25,629
MMG,100,75,0.007575757575757576,0.00126369995996356,25,629
SoA heuristic,200,150,0.0037688442211055275,0.00010600010864436626,50,2620
MMG,200,150,0.0037688442211055275,0.003303500125184655,50,2620
SoA heuristic,400,300,0.0018796992481203006,0.0002827998250722885,100,10130
MMG,400,300,0.0018796992481203006,0.01295039989054203,100,10130
SoA heuristic,600,450,0.0012520868113522537,0.0003238001372665167,150,22375
MMG,600,450,0.0012520868113522537,0.026120400056242943,150,22375
SoA heuristic,1000,750,0.0007507507507507507,0.0014637999702244997,250,62620
MMG,1000,750,0.0007507507507507507,0.06882759998552501,250,62620
SoA heuristic,2000,1500,0.00037518759379689845,0.0015755000058561563,500,250201
MMG,2000,1500,0.00037518759379689845,0.2926582000218332,500,250201
SoA heuristic,4000,3000,0.00018754688672168043,0.0024847001768648624,1000,1000368
MMG,4000,3000,0.00018754688672168043,1.2751726999413222,1000,1000368
SoA heuristic,8000,6000,9.376172021502688e-05,0.005709499819204211,2000,4001431
MMG,8000,6000,9.376172021502688e-05,5.2465838000644,2000,4001431
