name,nodes,edges,density,time,result_set,result_w
SoA heuristic,20,15,0.039473684210526314,2.110004425048828e-05,5,15
MMG,20,15,0.039473684210526314,0.00011829985305666924,5,15
SoA heuristic,40,30,0.019230769230769232,3.3400021493434906e-05,10,50
MMG,40,30,0.019230769230769232,0.0002359999343752861,10,50
SoA heuristic,100,75,0.007575757575757576,5.9999991208314896e-05,25,307
MMG,100,75,0.007575757575757576,0.0010042998474091291,25,307
SoA heuristic,200,150,0.0037688442211055275,0.00011040014214813709,50,1266
MMG,200,150,0.0037688442211055275,0.0033106000628322363,50,1266
SoA heuristic,400,300,0.0018796992481203006,0.00021909992210566998,100,4958
MMG,400,300,0.0018796992481203006,0.013044500024989247,100,4958
SoA heuristic,600,450,0.0012520868113522537,0.0003132999408990145,150,11294
MMG,600,450,0.0012520868113522537,0.027560600079596043,150,11294
SoA heuristic,1000,750,0.0007507507507507507,0.0005856000352650881,250,31317
MMG,1000,750,0.0007507507507507507,0.07409540005028248,250,31317
SoA heuristic,2000,1500,0.00037518759379689845,0.0010526999831199646,500,124937
MMG,2000,1500,0.00037518759379689845,0.27767009986564517,500,124937
SoA heuristic,4000,3000,0.00018754688672168043,0.0022934998851269484,1000,499313
MMG,4000,3000,0.00018754688672168043,1.1883926000446081,1000,499313
SoA heuristic,8000,6000,9.376172021502688e-05,0.033721499843522906,2000,2001171
MMG,8000,6000,9.376172021502688e-05,4.802588499849662,2000,2001171
SoA heuristic,20,15,0.039473684210526314,2.3200176656246185e-05,5,11
MMG,20,15,0.039473684210526314,0.00010300008580088615,5,11
SoA heuristic,40,30,0.019230769230769232,3.220001235604286e-05,10,45
MMG,40,30,0.019230769230769232,0.00024259998463094234,10,45
SoA heuristic,100,75,0.007575757575757576,7.520010694861412e-05,25,290
MMG,100,75,0.007575757575757576,0.0010186000727117062,25,290
SoA heuristic,200,150,0.0037688442211055275,0.00011470005847513676,50,1205
MMG,200,150,0.0037688442211055275,0.0033982000313699245,50,1205
SoA heuristic,400,300,0.0018796992481203006,0.00023550004698336124,100,5054
MMG,400,300,0.0018796992481203006,0.012588900048285723,100,5054
SoA heuristic,600,450,0.0012520868113522537,0.00036700000055134296,150,11235
MMG,600,450,0.0012520868113522537,0.028129100101068616,150,11235
SoA heuristic,1000,750,0.0007507507507507507,0.0006013000383973122,250,30968
MMG,1000,750,0.0007507507507507507,0.07457960001192987,250,30968
SoA heuristic,2000,1500,0.00037518759379689845,0.0010785998310893774,500,124650
MMG,2000,1500,0.00037518759379689845,0.2945568000432104,500,124650
SoA heuristic,4000,3000,0.00018754688672168043,0.002729400061070919,1000,499303
MMG,4000,3000,0.00018754688672168043,1.184590700082481,1000,499303
SoA heuristic,8000,6000,9.376172021502688e-05,0.004500600043684244,2000,2000652
MMG,8000,6000,9.376172021502688e-05,4.512775199953467,2000,2000652
SoA heuristic,20,15,0.039473684210526314,2.1999934688210487e-05,5,16
MMG,20,15,0.039473684210526314,0.00010060006752610207,5,16
SoA heuristic,40,30,0.019230769230769232,3.509991802275181e-05,10,43
MMG,40,30,0.019230769230769232,0.00025669997557997704,10,43
SoA heuristic,100,75,0.007575757575757576,5.569984205067158e-05,25,324
MMG,100,75,0.007575757575757576,0.0009592000860720873,25,324
SoA heuristic,200,150,0.0037688442211055275,0.0001091999001801014,50,1243
MMG,200,150,0.0037688442211055275,0.003357799956575036,50,1243
SoA heuristic,400,300,0.0018796992481203006,0.00020570005290210247,100,4976
MMG,400,300,0.0018796992481203006,0.012603600043803453,100,4976
SoA heuristic,600,450,0.0012520868113522537,0.0002973000518977642,150,11273
MMG,600,450,0.0012520868113522537,0.02711179992184043,150,11273
SoA heuristic,1000,750,0.0007507507507507507,0.0005597998388111591,250,31262
MMG,1000,750,0.0007507507507507507,0.07306169997900724,250,31262
SoA heuristic,2000,1500,0.00037518759379689845,0.0011183999013155699,500,125113
MMG,2000,1500,0.00037518759379689845,0.2921116000507027,500,125113
SoA heuristic,4000,3000,0.00018754688672168043,0.002297000028192997,1000,500171
MMG,4000,3000,0.00018754688672168043,1.1928444998338819,1000,500171
SoA heuristic,8000,6000,9.376172021502688e-05,0.033284599892795086,2000,1998183
MMG,8000,6000,9.376172021502688e-05,5.1607095000799745,2000,1998183
SoA heuristic,20,15,0.039473684210526314,2.269982360303402e-05,5,10
MMG,20,15,0.039473684210526314,0.00010890001431107521,5,10
SoA heuristic,40,30,0.019230769230769232,2.7999980375170708e-05,10,51
MMG,40,30,0.019230769230769232,0.0002234999556094408,10,51
SoA heuristic,100,75,0.007575757575757576,0.000171000137925148,25,280
MMG,100,75,0.007575757575757576,0.002629099879413843,25,280
SoA heuristic,200,150,0.0037688442211055275,0.00010700011625885963,50,1272
MMG,200,150,0.0037688442211055275,0.0031188998837023973,50,1272
SoA heuristic,400,300,0.0018796992481203006,0.00021500000730156898,100,4971
MMG,400,300,0.0018796992481203006,0.013647600077092648,100,4971
SoA heuristic,600,450,0.0012520868113522537,0.0008465999271720648,150,11301
MMG,600,450,0.0012520868113522537,0.04397560004144907,150,11301
SoA heuristic,1000,750,0.0007507507507507507,0.0005470998585224152,250,31110
MMG,1000,750,0.0007507507507507507,0.10466070007532835,250,31110
SoA heuristic,2000,1500,0.00037518759379689845,0.0010240001138299704,500,124936
MMG,2000,1500,0.00037518759379689845,0.4670491998549551,500,124936
SoA heuristic,4000,3000,0.00018754688672168043,0.004208499798551202,1000,499860
MMG,4000,3000,0.00018754688672168043,1.6499999999068677,1000,499860
SoA heuristic,8000,6000,9.376172021502688e-05,0.014288299949839711,2000,2000237
MMG,8000,6000,9.376172021502688e-05,7.517530899960548,2000,2000237
SoA heuristic,20,15,0.039473684210526314,3.329990431666374e-05,5,12
MMG,20,15,0.039473684210526314,0.00016449997201561928,5,12
SoA heuristic,40,30,0.019230769230769232,4.090019501745701e-05,10,53
MMG,40,30,0.019230769230769232,0.00033139996230602264,10,53
SoA heuristic,100,75,0.007575757575757576,5.450006574392319e-05,25,324
MMG,100,75,0.007575757575757576,0.0014595000538975,25,324
SoA heuristic,200,150,0.0037688442211055275,9.869993664324284e-05,50,1290
MMG,200,150,0.0037688442211055275,0.003060499904677272,50,1290
SoA heuristic,400,300,0.0018796992481203006,0.00018560001626610756,100,5090
MMG,400,300,0.0018796992481203006,0.014626799849793315,100,5090
SoA heuristic,600,450,0.0012520868113522537,0.0003969999961555004,150,11236
MMG,600,450,0.0012520868113522537,0.06880700006149709,150,11236
SoA heuristic,1000,750,0.0007507507507507507,0.0005399000365287066,250,31154
MMG,1000,750,0.0007507507507507507,0.11140609998255968,250,31154
SoA heuristic,2000,1500,0.00037518759379689845,0.0010287000332027674,500,125338
MMG,2000,1500,0.00037518759379689845,0.4988437998108566,500,125338
SoA heuristic,4000,3000,0.00018754688672168043,0.002071700058877468,1000,499945
MMG,4000,3000,0.00018754688672168043,1.8387583999428898,1000,499945
SoA heuristic,8000,6000,9.376172021502688e-05,0.014215299859642982,2000,2000733
MMG,8000,6000,9.376172021502688e-05,7.341783300042152,2000,2000733
SoA heuristic,20,15,0.039473684210526314,1.9300030544400215e-05,5,5
MMG,20,15,0.039473684210526314,9.50000248849392e-05,5,5
SoA heuristic,40,30,0.019230769230769232,8.939998224377632e-05,10,44
MMG,40,30,0.019230769230769232,0.0006935999263077974,10,44
SoA heuristic,100,75,0.007575757575757576,5.530007183551788e-05,25,333
MMG,100,75,0.007575757575757576,0.000891899922862649,25,333
SoA heuristic,200,150,0.0037688442211055275,0.0001020999625325203,50,1242
MMG,200,150,0.0037688442211055275,0.006354600191116333,50,1242
SoA heuristic,400,300,0.0018796992481203006,0.0001876000314950943,100,4945
MMG,400,300,0.0018796992481203006,0.011183599941432476,100,4945
SoA heuristic,600,450,0.0012520868113522537,0.0008547999896109104,150,11153
MMG,600,450,0.0012520868113522537,0.07034149998798966,150,11153
SoA heuristic,1000,750,0.0007507507507507507,0.0009669999126344919,250,31222
MMG,1000,750,0.0007507507507507507,0.07753599993884563,250,31222
SoA heuristic,2000,1500,0.00037518759379689845,0.002998699899762869,500,124590
MMG,2000,1500,0.00037518759379689845,0.46865960001014173,500,124590
SoA heuristic,4000,3000,0.00018754688672168043,0.008778800023719668,1000,499876
MMG,4000,3000,0.00018754688672168043,2.020509900059551,1000,499876
SoA heuristic,8000,6000,9.376172021502688e-05,0.03623279999010265,2000,1998419
MMG,8000,6000,9.376172021502688e-05,7.314405799843371,2000,1998419
SoA heuristic,20,15,0.039473684210526314,5.21000474691391e-05,5,11
MMG,20,15,0.039473684210526314,0.00022179982624948025,5,11
SoA heuristic,40,30,0.019230769230769232,2.9900111258029938e-05,10,56
MMG,40,30,0.019230769230769232,0.0002327000256627798,10,56
SoA heuristic,100,75,0.007575757575757576,7.239985279738903e-05,25,328
MMG,100,75,0.007575757575757576,0.0012923998292535543,25,328
SoA heuristic,200,150,0.0037688442211055275,0.00022869999520480633,50,1215
MMG,200,150,0.0037688442211055275,0.0047079999931156635,50,1215
SoA heuristic,400,300,0.0018796992481203006,0.0005742001812905073,100,5000
MMG,400,300,0.0018796992481203006,0.011892699869349599,100,5000
SoA heuristic,600,450,0.0012520868113522537,0.0008356999605894089,150,11139
MMG,600,450,0.0012520868113522537,0.05657650018110871,150,11139
SoA heuristic,1000,750,0.0007507507507507507,0.00098209991119802,250,31232
MMG,1000,750,0.0007507507507507507,0.15713969990611076,250,31232
SoA heuristic,2000,1500,0.00037518759379689845,0.0011521000415086746,500,125340
MMG,2000,1500,0.00037518759379689845,0.4256704000290483,500,125340
SoA heuristic,4000,3000,0.00018754688672168043,0.0035993000492453575,1000,500185
MMG,4000,3000,0.00018754688672168043,1.7043010001070797,1000,500185
SoA heuristic,8000,6000,9.376172021502688e-05,0.005475900135934353,2000,1997922
MMG,8000,6000,9.376172021502688e-05,6.905040299985558,2000,1997922
SoA heuristic,20,15,0.039473684210526314,1.9799917936325073e-05,5,11
MMG,20,15,0.039473684210526314,9.099999442696571e-05,5,11
SoA heuristic,40,30,0.019230769230769232,3.800005652010441e-05,10,45
MMG,40,30,0.019230769230769232,0.00030860002152621746,10,45
SoA heuristic,100,75,0.007575757575757576,8.519995026290417e-05,25,314
MMG,100,75,0.007575757575757576,0.0014748999383300543,25,314
SoA heuristic,200,150,0.0037688442211055275,0.0003166000824421644,50,1232
MMG,200,150,0.0037688442211055275,0.009444599971175194,50,1232
SoA heuristic,400,300,0.0018796992481203006,0.0004980999510735273,100,5018
MMG,400,300,0.0018796992481203006,0.016740099992603064,100,5018
SoA heuristic,600,450,0.0012520868113522537,0.00031569995917379856,150,11318
MMG,600,450,0.0012520868113522537,0.048182700062170625,150,11318
SoA heuristic,1000,750,0.0007507507507507507,0.0015976999420672655,250,31355
MMG,1000,750,0.0007507507507507507,0.1342354000080377,250,31355
SoA heuristic,2000,1500,0.00037518759379689845,0.002342799911275506,500,125264
MMG,2000,1500,0.00037518759379689845,0.469877399969846,500,125264
SoA heuristic,4000,3000,0.00018754688672168043,0.0023384999949485064,1000,499282
MMG,4000,3000,0.00018754688672168043,1.9663288001902401,1000,499282
SoA heuristic,8000,6000,9.376172021502688e-05,0.011425599921494722,2000,2000857
MMG,8000,6000,9.376172021502688e-05,7.39569989987649,2000,2000857
SoA heuristic,20,15,0.039473684210526314,3.369990736246109e-05,5,11
MMG,20,15,0.039473684210526314,0.0001642999704927206,5,11
SoA heuristic,40,30,0.019230769230769232,3.0100112780928612e-05,10,45
MMG,40,30,0.019230769230769232,0.0002221998292952776,10,45
SoA heuristic,100,75,0.007575757575757576,0.00015579978935420513,25,296
MMG,100,75,0.007575757575757576,0.0022455998696386814,25,296
SoA heuristic,200,150,0.0037688442211055275,0.00024019996635615826,50,1232
MMG,200,150,0.0037688442211055275,0.005441499873995781,50,1232
SoA heuristic,400,300,0.0018796992481203006,0.0005806998815387487,100,4976
MMG,400,300,0.0018796992481203006,0.021042099921032786,100,4976
SoA heuristic,600,450,0.0012520868113522537,0.0002782999072223902,150,11141
MMG,600,450,0.0012520868113522537,0.040902999928221107,150,11141
SoA heuristic,1000,750,0.0007507507507507507,0.0013181997928768396,250,31152
MMG,1000,750,0.0007507507507507507,0.08833319996483624,250,31152
SoA heuristic,2000,1500,0.00037518759379689845,0.002697699936106801,500,124370
MMG,2000,1500,0.00037518759379689845,0.5566666999366134,500,124370
SoA heuristic,4000,3000,0.00018754688672168043,0.006886300165206194,1000,499666
MMG,4000,3000,0.00018754688672168043,1.7050798998679966,1000,499666
SoA heuristic,8000,6000,9.376172021502688e-05,0.05160750006325543,2000,1999835
MMG,8000,6000,9.376172021502688e-05,7.6845875000581145,2000,1999835
SoA heuristic,20,15,0.039473684210526314,6.700004450976849e-05,5,12
MMG,20,15,0.039473684210526314,0.0004851999692618847,5,12
SoA heuristic,40,30,0.019230769230769232,3.7999823689460754e-05,10,45
MMG,40,30,0.019230769230769232,0.00027089985087513924,10,45
SoA heuristic,100,75,0.007575757575757576,5.719996988773346e-05,25,334
MMG,100,75,0.007575757575757576,0.0009087000507861376,25,334
SoA heuristic,200,150,0.0037688442211055275,0.00010760012082755566,50,1298
MMG,200,150,0.0037688442211055275,0.008256899891421199,50,1298
SoA heuristic,400,300,0.0018796992481203006,0.00019589997828006744,100,4965
MMG,400,300,0.0018796992481203006,0.011416100198403,100,4965
SoA heuristic,600,450,0.0012520868113522537,0.0009067000355571508,150,11270
MMG,600,450,0.0012520868113522537,0.04137110011652112,150,11270
SoA heuristic,1000,750,0.0007507507507507507,0.0005075999069958925,250,31271
MMG,1000,750,0.0007507507507507507,0.13035689992830157,250,31271
SoA heuristic,2000,1500,0.00037518759379689845,0.0012418001424521208,500,124976
MMG,2000,1500,0.00037518759379689845,0.5081226998008788,500,124976
SoA heuristic,4000,3000,0.00018754688672168043,0.006944200024008751,1000,499953
MMG,4000,3000,0.00018754688672168043,2.1530651000794023,1000,499953
SoA heuristic,8000,6000,9.376172021502688e-05,0.06817570002749562,2000,1998671
MMG,8000,6000,9.376172021502688e-05,7.573175200028345,2000,1998671
SoA heuristic,20,15,0.039473684210526314,7.950002327561378e-05,5,12
MMG,20,15,0.039473684210526314,0.0003231000155210495,5,12
SoA heuristic,40,30,0.019230769230769232,5.789985880255699e-05,10,53
MMG,40,30,0.019230769230769232,0.000493600033223629,10,53
SoA heuristic,100,75,0.007575757575757576,5.719996988773346e-05,25,321
MMG,100,75,0.007575757575757576,0.0009249001741409302,25,321
SoA heuristic,200,150,0.0037688442211055275,0.00016659987159073353,50,1257
MMG,200,150,0.0037688442211055275,0.003660899819806218,50,1257
SoA heuristic,400,300,0.0018796992481203006,0.0005689999088644981,100,4928
MMG,400,300,0.0018796992481203006,0.01961840013973415,100,4928
SoA heuristic,600,450,0.0012520868113522537,0.00027820002287626266,150,11261
MMG,600,450,0.0012520868113522537,0.04777260008268058,150,11261
SoA heuristic,1000,750,0.0007507507507507507,0.0005958001129329205,250,31452
MMG,1000,750,0.0007507507507507507,0.12083120015449822,250,31452
SoA heuristic,2000,1500,0.00037518759379689845,0.0030849999748170376,500,124823
MMG,2000,1500,0.00037518759379689845,0.46405770001001656,500,124823
SoA heuristic,4000,3000,0.00018754688672168043,0.002019600011408329,1000,499732
MMG,4000,3000,0.00018754688672168043,2.050026800017804,1000,499732
SoA heuristic,8000,6000,9.376172021502688e-05,0.005527900066226721,2000,2000146
MMG,8000,6000,9.376172021502688e-05,7.604114999994636,2000,2000146
SoA heuristic,20,15,0.039473684210526314,2.559996210038662e-05,5,16
MMG,20,15,0.039473684210526314,0.00011999998241662979,5,16
SoA heuristic,40,30,0.019230769230769232,3.0300114303827286e-05,10,55
MMG,40,30,0.019230769230769232,0.00022330018691718578,10,55
SoA heuristic,100,75,0.007575757575757576,5.610007792711258e-05,25,313
MMG,100,75,0.007575757575757576,0.0009294000919908285,25,313
SoA heuristic,200,150,0.0037688442211055275,0.00010539987124502659,50,1243
MMG,200,150,0.0037688442211055275,0.0035381000488996506,50,1243
SoA heuristic,400,300,0.0018796992481203006,0.0005409000441431999,100,4921
MMG,400,300,0.0018796992481203006,0.0327481001149863,100,4921
SoA heuristic,600,450,0.0012520868113522537,0.0003149998374283314,150,11503
MMG,600,450,0.0012520868113522537,0.024367400212213397,150,11503
SoA heuristic,1000,750,0.0007507507507507507,0.0012284000404179096,250,31047
MMG,1000,750,0.0007507507507507507,0.1271943999454379,250,31047
SoA heuristic,2000,1500,0.00037518759379689845,0.0017419001087546349,500,124661
MMG,2000,1500,0.00037518759379689845,0.4574982998892665,500,124661
SoA heuristic,4000,3000,0.00018754688672168043,0.007295900024473667,1000,500262
MMG,4000,3000,0.00018754688672168043,1.9950250999536365,1000,500262
SoA heuristic,8000,6000,9.376172021502688e-05,0.06091129989363253,2000,2000282
MMG,8000,6000,9.376172021502688e-05,7.559839100111276,2000,2000282
SoA heuristic,20,15,0.039473684210526314,2.0399922505021095e-05,5,12
MMG,20,15,0.039473684210526314,9.449990466237068e-05,5,12
SoA heuristic,40,30,0.019230769230769232,3.7400051951408386e-05,10,48
MMG,40,30,0.019230769230769232,0.0003060000017285347,10,48
SoA heuristic,100,75,0.007575757575757576,8.699996396899223e-05,25,311
MMG,100,75,0.007575757575757576,0.0014788999687880278,25,311
SoA heuristic,200,150,0.0037688442211055275,0.00034300005063414574,50,1244
MMG,200,150,0.0037688442211055275,0.009544099913910031,50,1244
SoA heuristic,400,300,0.0018796992481203006,0.00018339999951422215,100,4967
MMG,400,300,0.0018796992481203006,0.01581330015324056,100,4967
SoA heuristic,600,450,0.0012520868113522537,0.0007557999342679977,150,11160
MMG,600,450,0.0012520868113522537,0.05305429990403354,150,11160
SoA heuristic,1000,750,0.0007507507507507507,0.0011519999243319035,250,31261
MMG,1000,750,0.0007507507507507507,0.13708999985828996,250,31261
SoA heuristic,2000,1500,0.00037518759379689845,0.0025855000130832195,500,124945
MMG,2000,1500,0.00037518759379689845,0.44250339991413057,500,124945
SoA heuristic,4000,3000,0.00018754688672168043,0.0021714000031352043,1000,499504
MMG,4000,3000,0.00018754688672168043,1.701676500029862,1000,499504
SoA heuristic,8000,6000,9.376172021502688e-05,0.0127598000690341,2000,1999464
MMG,8000,6000,9.376172021502688e-05,7.634026899933815,2000,1999464
SoA heuristic,20,15,0.039473684210526314,2.1999934688210487e-05,5,14
MMG,20,15,0.039473684210526314,9.440002031624317e-05,5,14
SoA heuristic,40,30,0.019230769230769232,5.170004442334175e-05,10,56
MMG,40,30,0.019230769230769232,0.0003739998210221529,10,56
SoA heuristic,100,75,0.007575757575757576,6.08998816460371e-05,25,310
MMG,100,75,0.007575757575757576,0.0009130998514592648,25,310
SoA heuristic,200,150,0.0037688442211055275,0.00014239992015063763,50,1249
MMG,200,150,0.0037688442211055275,0.0031971000134944916,50,1249
SoA heuristic,400,300,0.0018796992481203006,0.00036140019074082375,100,4994
MMG,400,300,0.0018796992481203006,0.03513279999606311,100,4994
SoA heuristic,600,450,0.0012520868113522537,0.0004661001730710268,150,11240
MMG,600,450,0.0012520868113522537,0.05250579980202019,150,11240
SoA heuristic,1000,750,0.0007507507507507507,0.000553100137040019,250,31152
MMG,1000,750,0.0007507507507507507,0.12904020003043115,250,31152
SoA heuristic,2000,1500,0.00037518759379689845,0.0019275001250207424,500,124940
MMG,2000,1500,0.00037518759379689845,0.47000049985945225,500,124940
SoA heuristic,4000,3000,0.00018754688672168043,0.0024826000444591045,1000,500559
MMG,4000,3000,0.00018754688672168043,1.9876816000323743,1000,500559
SoA heuristic,8000,6000,9.376172021502688e-05,0.009088199818506837,2000,1999481
MMG,8000,6000,9.376172021502688e-05,7.1611945000477135,2000,1999481
SoA heuristic,20,15,0.039473684210526314,3.6800047382712364e-05,5,16
MMG,20,15,0.039473684210526314,0.00019189994782209396,5,16
SoA heuristic,40,30,0.019230769230769232,2.759997732937336e-05,10,55
MMG,40,30,0.019230769230769232,0.00021540001034736633,10,55
SoA heuristic,100,75,0.007575757575757576,5.479995161294937e-05,25,312
MMG,100,75,0.007575757575757576,0.0008972999639809132,25,312
SoA heuristic,200,150,0.0037688442211055275,0.000283299945294857,50,1239
MMG,200,150,0.0037688442211055275,0.009302400052547455,50,1239
SoA heuristic,400,300,0.0018796992481203006,0.0003090000245720148,100,5023
MMG,400,300,0.0018796992481203006,0.013132799882441759,100,5023
SoA heuristic,600,450,0.0012520868113522537,0.0002797998022288084,150,11229
MMG,600,450,0.0012520868113522537,0.02534770010970533,150,11229
SoA heuristic,1000,750,0.0007507507507507507,0.0016177999787032604,250,31104
MMG,1000,750,0.0007507507507507507,0.12599550001323223,250,31104
SoA heuristic,2000,1500,0.00037518759379689845,0.002071299823001027,500,125127
MMG,2000,1500,0.00037518759379689845,0.507018500007689,500,125127
SoA heuristic,4000,3000,0.00018754688672168043,0.0020429000724107027,1000,499072
MMG,4000,3000,0.00018754688672168043,1.793898800155148,1000,499072
SoA heuristic,8000,6000,9.376172021502688e-05,0.015842700144276023,2000,1999131
MMG,8000,6000,9.376172021502688e-05,7.6420035001356155,2000,1999131
SoA heuristic,20,15,0.039473684210526314,6.469991058111191e-05,5,12
MMG,20,15,0.039473684210526314,0.00030349986627697945,5,12
SoA heuristic,40,30,0.019230769230769232,9.249988943338394e-05,10,58
MMG,40,30,0.019230769230769232,0.0007289000786840916,10,58
SoA heuristic,100,75,0.007575757575757576,5.339994095265865e-05,25,314
MMG,100,75,0.007575757575757576,0.00090929982252419,25,314
SoA heuristic,200,150,0.0037688442211055275,0.00028280005790293217,50,1196
MMG,200,150,0.0037688442211055275,0.009837100049480796,50,1196
SoA heuristic,400,300,0.0018796992481203006,0.0004088000860065222,100,4957
MMG,400,300,0.0018796992481203006,0.02574900002218783,100,4957
SoA heuristic,600,450,0.0012520868113522537,0.0010333000682294369,150,11247
MMG,600,450,0.0012520868113522537,0.049803800182417035,150,11247
SoA heuristic,1000,750,0.0007507507507507507,0.0005522998981177807,250,31277
MMG,1000,750,0.0007507507507507507,0.1125076999887824,250,31277
SoA heuristic,2000,1500,0.00037518759379689845,0.002704799873754382,500,124793
MMG,2000,1500,0.00037518759379689845,0.4918058000039309,500,124793
SoA heuristic,4000,3000,0.00018754688672168043,0.006480099866166711,1000,499738
MMG,4000,3000,0.00018754688672168043,1.6784790998790413,1000,499738
SoA heuristic,8000,6000,9.376172021502688e-05,0.011649900116026402,2000,1999645
MMG,8000,6000,9.376172021502688e-05,7.392294000135735,2000,1999645
SoA heuristic,20,15,0.039473684210526314,3.860006108880043e-05,5,13
MMG,20,15,0.039473684210526314,0.0001816998701542616,5,13
SoA heuristic,40,30,0.019230769230769232,3.390014171600342e-05,10,52
MMG,40,30,0.019230769230769232,0.0002661999315023422,10,52
SoA heuristic,100,75,0.007575757575757576,5.410006269812584e-05,25,311
MMG,100,75,0.007575757575757576,0.0009059000294655561,25,311
SoA heuristic,200,150,0.0037688442211055275,0.0002926001325249672,50,1277
MMG,200,150,0.0037688442211055275,0.006890600081533194,50,1277
SoA heuristic,400,300,0.0018796992481203006,0.00026679993607103825,100,5031
MMG,400,300,0.0018796992481203006,0.028654299909248948,100,5031
SoA heuristic,600,450,0.0012520868113522537,0.0002817001659423113,150,11250
MMG,600,450,0.0012520868113522537,0.03464119997806847,150,11250
SoA heuristic,1000,750,0.0007507507507507507,0.0016106001567095518,250,31096
MMG,1000,750,0.0007507507507507507,0.14585219998843968,250,31096
SoA heuristic,2000,1500,0.00037518759379689845,0.0011460999958217144,500,124925
MMG,2000,1500,0.00037518759379689845,0.48856339999474585,500,124925
SoA heuristic,4000,3000,0.00018754688672168043,0.0022628000006079674,1000,500116
MMG,4000,3000,0.00018754688672168043,1.9444231998641044,1000,500116
SoA heuristic,8000,6000,9.376172021502688e-05,0.011735199950635433,2000,1998576
MMG,8000,6000,9.376172021502688e-05,7.524647800019011,2000,1998576
SoA heuristic,20,15,0.039473684210526314,2.110004425048828e-05,5,13
MMG,20,15,0.039473684210526314,9.580003097653389e-05,5,13
SoA heuristic,40,30,0.019230769230769232,2.7900096029043198e-05,10,37
MMG,40,30,0.019230769230769232,0.00021760002709925175,10,37
SoA heuristic,100,75,0.007575757575757576,0.00016270019114017487,25,326
MMG,100,75,0.007575757575757576,0.0027042999863624573,25,326
SoA heuristic,200,150,0.0037688442211055275,0.0003400000277906656,50,1208
MMG,200,150,0.0037688442211055275,0.00550720002502203,50,1208
SoA heuristic,400,300,0.0018796992481203006,0.0007702999282628298,100,5040
MMG,400,300,0.0018796992481203006,0.028064200188964605,100,5040
SoA heuristic,600,450,0.0012520868113522537,0.0002840000670403242,150,11272
MMG,600,450,0.0012520868113522537,0.036708799889311194,150,11272
SoA heuristic,1000,750,0.0007507507507507507,0.0015922999009490013,250,31351
MMG,1000,750,0.0007507507507507507,0.08581060008145869,250,31351
SoA heuristic,2000,1500,0.00037518759379689845,0.0029380000196397305,500,124756
MMG,2000,1500,0.00037518759379689845,0.5749009000137448,500,124756
SoA heuristic,4000,3000,0.00018754688672168043,0.0019934000447392464,1000,500037
MMG,4000,3000,0.00018754688672168043,1.9396374002099037,1000,500037
SoA heuristic,8000,6000,9.376172021502688e-05,0.044254399836063385,2000,2000576
MMG,8000,6000,9.376172021502688e-05,7.398623200133443,2000,2000576
SoA heuristic,20,15,0.039473684210526314,2.0700041204690933e-05,5,13
MMG,20,15,0.039473684210526314,9.660003706812859e-05,5,13
SoA heuristic,40,30,0.019230769230769232,2.810009755194187e-05,10,48
MMG,40,30,0.019230769230769232,0.0002671000547707081,10,48
SoA heuristic,100,75,0.007575757575757576,5.9999991208314896e-05,25,290
MMG,100,75,0.007575757575757576,0.0009551001712679863,25,290
SoA heuristic,200,150,0.0037688442211055275,9.8800053820014e-05,50,1260
MMG,200,150,0.0037688442211055275,0.003008600091561675,50,1260
SoA heuristic,400,300,0.0018796992481203006,0.00019340007565915585,100,4941
MMG,400,300,0.0018796992481203006,0.028034100076183677,100,4941
SoA heuristic,600,450,0.0012520868113522537,0.0002774999011307955,150,11286
MMG,600,450,0.0012520868113522537,0.04251620010472834,150,11286
SoA heuristic,1000,750,0.0007507507507507507,0.000526099931448698,250,31520
MMG,1000,750,0.0007507507507507507,0.08325790008530021,250,31520
SoA heuristic,2000,1500,0.00037518759379689845,0.0033560998272150755,500,125247
MMG,2000,1500,0.00037518759379689845,0.5224135001190007,500,125247
SoA heuristic,4000,3000,0.00018754688672168043,0.006954799871891737,1000,500181
MMG,4000,3000,0.00018754688672168043,1.83444879995659,1000,500181
SoA heuristic,8000,6000,9.376172021502688e-05,0.013431899948045611,2000,2001319
MMG,8000,6000,9.376172021502688e-05,7.593090299982578,2000,2001319
SoA heuristic,20,15,0.039473684210526314,6.349990144371986e-05,5,12
MMG,20,15,0.039473684210526314,0.0005464002024382353,5,12
SoA heuristic,40,30,0.019230769230769232,8.080014958977699e-05,10,47
MMG,40,30,0.019230769230769232,0.0006264999974519014,10,47
SoA heuristic,100,75,0.007575757575757576,5.7900091633200645e-05,25,311
MMG,100,75,0.007575757575757576,0.0009045999031513929,25,311
SoA heuristic,200,150,0.0037688442211055275,9.869993664324284e-05,50,1287
MMG,200,150,0.0037688442211055275,0.003101599868386984,50,1287
SoA heuristic,400,300,0.0018796992481203006,0.0005840000230818987,100,4973
MMG,400,300,0.0018796992481203006,0.03031489998102188,100,4973
SoA heuristic,600,450,0.0012520868113522537,0.0002880000974982977,150,11250
MMG,600,450,0.0012520868113522537,0.02722330018877983,150,11250
SoA heuristic,1000,750,0.0007507507507507507,0.0005237001460045576,250,31490
MMG,1000,750,0.0007507507507507507,0.12575039989314973,250,31490
SoA heuristic,2000,1500,0.00037518759379689845,0.0013697999529540539,500,125030
MMG,2000,1500,0.00037518759379689845,0.4970423001796007,500,125030
SoA heuristic,4000,3000,0.00018754688672168043,0.003794299904257059,1000,499956
MMG,4000,3000,0.00018754688672168043,1.961775799980387,1000,499956
SoA heuristic,8000,6000,9.376172021502688e-05,0.007890200009569526,2000,2001150
MMG,8000,6000,9.376172021502688e-05,7.628184299916029,2000,2001150
SoA heuristic,20,15,0.039473684210526314,2.2500054910779e-05,5,11
MMG,20,15,0.039473684210526314,0.00010140007361769676,5,11
SoA heuristic,40,30,0.019230769230769232,3.469991497695446e-05,10,50
MMG,40,30,0.019230769230769232,0.0002967999316751957,10,50
SoA heuristic,100,75,0.007575757575757576,5.759997293353081e-05,25,326
MMG,100,75,0.007575757575757576,0.0009260999504476786,25,326
SoA heuristic,200,150,0.0037688442211055275,0.00010110018774867058,50,1264
MMG,200,150,0.0037688442211055275,0.0031729000620543957,50,1264
SoA heuristic,400,300,0.0018796992481203006,0.0005272000562399626,100,5057
MMG,400,300,0.0018796992481203006,0.02900329977273941,100,5057
SoA heuristic,600,450,0.0012520868113522537,0.0002718998584896326,150,11280
MMG,600,450,0.0012520868113522537,0.02529260003939271,150,11280
SoA heuristic,1000,750,0.0007507507507507507,0.001730400137603283,250,31252
MMG,1000,750,0.0007507507507507507,0.1300278000999242,250,31252
SoA heuristic,2000,1500,0.00037518759379689845,0.001568600069731474,500,124783
MMG,2000,1500,0.00037518759379689845,0.4910514000803232,500,124783
SoA heuristic,4000,3000,0.00018754688672168043,0.006702800048515201,1000,500335
MMG,4000,3000,0.00018754688672168043,1.8890909999608994,1000,500335
SoA heuristic,8000,6000,9.376172021502688e-05,0.05404739989899099,2000,2000338
MMG,8000,6000,9.376172021502688e-05,7.493366600014269,2000,2000338
SoA heuristic,20,15,0.039473684210526314,1.9499799236655235e-05,5,11
MMG,20,15,0.039473684210526314,9.540002793073654e-05,5,11
SoA heuristic,40,30,0.019230769230769232,2.8999987989664078e-05,10,49
MMG,40,30,0.019230769230769232,0.00022500008344650269,10,49
SoA heuristic,100,75,0.007575757575757576,6.950017996132374e-05,25,288
MMG,100,75,0.007575757575757576,0.0011235999409109354,25,288
SoA heuristic,200,150,0.0037688442211055275,0.0003207998815923929,50,1250
MMG,200,150,0.0037688442211055275,0.00946910004131496,50,1250
SoA heuristic,400,300,0.0018796992481203006,0.00018570013344287872,100,5017
MMG,400,300,0.0018796992481203006,0.01448460016399622,100,5017
SoA heuristic,600,450,0.0012520868113522537,0.0008821000810712576,150,11203
MMG,600,450,0.0012520868113522537,0.043801600113511086,150,11203
SoA heuristic,1000,750,0.0007507507507507507,0.001591100124642253,250,31389
MMG,1000,750,0.0007507507507507507,0.15116410003975034,250,31389
SoA heuristic,2000,1500,0.00037518759379689845,0.002984799910336733,500,125000
MMG,2000,1500,0.00037518759379689845,0.45774139999412,500,125000
SoA heuristic,4000,3000,0.00018754688672168043,0.0024300001095980406,1000,499935
MMG,4000,3000,0.00018754688672168043,1.8035716998856515,1000,499935
SoA heuristic,8000,6000,9.376172021502688e-05,0.033122200053185225,2000,1999381
MMG,8000,6000,9.376172021502688e-05,7.694630900165066,2000,1999381
SoA heuristic,20,15,0.039473684210526314,6.730016320943832e-05,5,9
MMG,20,15,0.039473684210526314,0.0003105001524090767,5,9
SoA heuristic,40,30,0.019230769230769232,8.650007657706738e-05,10,48
MMG,40,30,0.019230769230769232,0.0007329999934881926,10,48
SoA heuristic,100,75,0.007575757575757576,0.0001797000877559185,25,295
MMG,100,75,0.007575757575757576,0.0027755999471992254,25,295
SoA heuristic,200,150,0.0037688442211055275,9.689992293715477e-05,50,1262
MMG,200,150,0.0037688442211055275,0.00480640004388988,50,1262
SoA heuristic,400,300,0.0018796992481203006,0.00018550013191998005,100,4928
MMG,400,300,0.0018796992481203006,0.014819499803707004,100,4928
SoA heuristic,600,450,0.0012520868113522537,0.0002816000487655401,150,11347
MMG,600,450,0.0012520868113522537,0.04998150002211332,150,11347
SoA heuristic,1000,750,0.0007507507507507507,0.001287700142711401,250,31134
MMG,1000,750,0.0007507507507507507,0.17732810019515455,250,31134
SoA heuristic,2000,1500,0.00037518759379689845,0.001002300065010786,500,125522
MMG,2000,1500,0.00037518759379689845,0.5023439000360668,500,125522
SoA heuristic,4000,3000,0.00018754688672168043,0.006117500131949782,1000,499360
MMG,4000,3000,0.00018754688672168043,1.7714257000479847,1000,499360
SoA heuristic,8000,6000,9.376172021502688e-05,0.004244700074195862,2000,2000983
MMG,8000,6000,9.376172021502688e-05,7.483426199993119,2000,2000983
SoA heuristic,20,15,0.039473684210526314,2.0300038158893585e-05,5,13
MMG,20,15,0.039473684210526314,9.440002031624317e-05,5,13
SoA heuristic,40,30,0.019230769230769232,2.8399983420968056e-05,10,49
MMG,40,30,0.019230769230769232,0.0002205998171120882,10,49
SoA heuristic,100,75,0.007575757575757576,5.45999500900507e-05,25,322
MMG,100,75,0.007575757575757576,0.0008910000324249268,25,322
SoA heuristic,200,150,0.0037688442211055275,0.00015730015002191067,50,1258
MMG,200,150,0.0037688442211055275,0.0032750999089330435,50,1258
SoA heuristic,400,300,0.0018796992481203006,0.00018410012125968933,100,4973
MMG,400,300,0.0018796992481203006,0.014180499827489257,100,4973
SoA heuristic,600,450,0.0012520868113522537,0.00028540007770061493,150,11338
MMG,600,450,0.0012520868113522537,0.0289769999217242,150,11338
SoA heuristic,1000,750,0.0007507507507507507,0.0006126000080257654,250,31309
MMG,1000,750,0.0007507507507507507,0.11516729998402297,250,31309
SoA heuristic,2000,1500,0.00037518759379689845,0.0025923000648617744,500,124744
MMG,2000,1500,0.00037518759379689845,0.4819885001052171,500,124744
SoA heuristic,4000,3000,0.00018754688672168043,0.006167900050058961,1000,500462
MMG,4000,3000,0.00018754688672168043,1.7744863000698388,1000,500462
SoA heuristic,8000,6000,9.376172021502688e-05,0.006474199937656522,2000,2000097
MMG,8000,6000,9.376172021502688e-05,7.301029700087383,2000,2000097
SoA heuristic,20,15,0.039473684210526314,2.100015990436077e-05,5,11
MMG,20,15,0.039473684210526314,9.739981032907963e-05,5,11
SoA heuristic,40,30,0.019230769230769232,3.1400006264448166e-05,10,51
MMG,40,30,0.019230769230769232,0.0002302001230418682,10,51
SoA heuristic,100,75,0.007575757575757576,5.669984966516495e-05,25,314
MMG,100,75,0.007575757575757576,0.0009972001425921917,25,314
SoA heuristic,200,150,0.0037688442211055275,0.0002598999999463558,50,1226
MMG,200,150,0.0037688442211055275,0.004609100054949522,50,1226
SoA heuristic,400,300,0.0018796992481203006,0.00029419991187751293,100,5001
MMG,400,300,0.0018796992481203006,0.017749799881130457,100,5001
SoA heuristic,600,450,0.0012520868113522537,0.0005206000059843063,150,11254
MMG,600,450,0.0012520868113522537,0.030008799862116575,150,11254
SoA heuristic,1000,750,0.0007507507507507507,0.0005352001171559095,250,31313
MMG,1000,750,0.0007507507507507507,0.08799290005117655,250,31313
SoA heuristic,2000,1500,0.00037518759379689845,0.0010240999981760979,500,125239
MMG,2000,1500,0.00037518759379689845,0.4355934001505375,500,125239
SoA heuristic,4000,3000,0.00018754688672168043,0.0022180001251399517,1000,500572
MMG,4000,3000,0.00018754688672168043,1.9964555001351982,1000,500572
SoA heuristic,8000,6000,9.376172021502688e-05,0.06169499992392957,2000,1999677
MMG,8000,6000,9.376172021502688e-05,7.637455400079489,2000,1999677
SoA heuristic,20,15,0.039473684210526314,2.0700041204690933e-05,5,14
MMG,20,15,0.039473684210526314,9.930017404258251e-05,5,14
SoA heuristic,40,30,0.019230769230769232,2.8499867767095566e-05,10,52
MMG,40,30,0.019230769230769232,0.00022160005755722523,10,52
SoA heuristic,100,75,0.007575757575757576,0.0002741999924182892,25,300
MMG,100,75,0.007575757575757576,0.0026365001685917377,25,300
SoA heuristic,200,150,0.0037688442211055275,0.00019970000721514225,50,1249
MMG,200,150,0.0037688442211055275,0.008687000023201108,50,1249
SoA heuristic,400,300,0.0018796992481203006,0.0005717999301850796,100,4962
MMG,400,300,0.0018796992481203006,0.03391249990090728,100,4962
SoA heuristic,600,450,0.0012520868113522537,0.0005261001642793417,150,11330
MMG,600,450,0.0012520868113522537,0.038535699946805835,150,11330
SoA heuristic,1000,750,0.0007507507507507507,0.0005152998492121696,250,31197
MMG,1000,750,0.0007507507507507507,0.11495619989000261,250,31197
SoA heuristic,2000,1500,0.00037518759379689845,0.0015706999693065882,500,124848
MMG,2000,1500,0.00037518759379689845,0.4640830000862479,500,124848
SoA heuristic,4000,3000,0.00018754688672168043,0.002058199839666486,1000,499869
MMG,4000,3000,0.00018754688672168043,2.1065738000907004,1000,499869
SoA heuristic,8000,6000,9.376172021502688e-05,0.051616800017654896,2000,1999662
MMG,8000,6000,9.376172021502688e-05,7.258252199972048,2000,1999662
SoA heuristic,20,15,0.039473684210526314,1.9800150766968727e-05,5,16
MMG,20,15,0.039473684210526314,9.409990161657333e-05,5,16
SoA heuristic,40,30,0.019230769230769232,2.8199981898069382e-05,10,59
MMG,40,30,0.019230769230769232,0.0002258999738842249,10,59
SoA heuristic,100,75,0.007575757575757576,5.5999960750341415e-05,25,300
MMG,100,75,0.007575757575757576,0.000905799912288785,25,300
SoA heuristic,200,150,0.0037688442211055275,0.00018420000560581684,50,1234
MMG,200,150,0.0037688442211055275,0.0035209001507610083,50,1234
SoA heuristic,400,300,0.0018796992481203006,0.0001838000025600195,100,4907
MMG,400,300,0.0018796992481203006,0.012111400021240115,100,4907
SoA heuristic,600,450,0.0012520868113522537,0.00028929999098181725,150,11277
MMG,600,450,0.0012520868113522537,0.043014700058847666,150,11277
SoA heuristic,1000,750,0.0007507507507507507,0.0008548998739570379,250,31181
MMG,1000,750,0.0007507507507507507,0.09816769999451935,250,31181
SoA heuristic,2000,1500,0.00037518759379689845,0.0010170000605285168,500,125040
MMG,2000,1500,0.00037518759379689845,0.3830981000792235,500,125040
SoA heuristic,4000,3000,0.00018754688672168043,0.007995899999514222,1000,500903
MMG,4000,3000,0.00018754688672168043,1.8738518999889493,1000,500903
SoA heuristic,8000,6000,9.376172021502688e-05,0.06569750001654029,2000,2000804
MMG,8000,6000,9.376172021502688e-05,7.677496399963275,2000,2000804
SoA heuristic,20,15,0.039473684210526314,2.019992098212242e-05,5,11
MMG,20,15,0.039473684210526314,9.329989552497864e-05,5,11
SoA heuristic,40,30,0.019230769230769232,2.759997732937336e-05,10,54
MMG,40,30,0.019230769230769232,0.00021750014275312424,10,54
SoA heuristic,100,75,0.007575757575757576,5.370005965232849e-05,25,329
MMG,100,75,0.007575757575757576,0.0009055999107658863,25,329
SoA heuristic,200,150,0.0037688442211055275,0.00027299998328089714,50,1214
MMG,200,150,0.0037688442211055275,0.008766900049522519,50,1214
SoA heuristic,400,300,0.0018796992481203006,0.0005875001661479473,100,4991
MMG,400,300,0.0018796992481203006,0.02075579995289445,100,4991
SoA heuristic,600,450,0.0012520868113522537,0.0002782999072223902,150,11175
MMG,600,450,0.0012520868113522537,0.03304750006645918,150,11175
SoA heuristic,1000,750,0.0007507507507507507,0.0005298999603837729,250,30880
MMG,1000,750,0.0007507507507507507,0.14446169999428093,250,30880
SoA heuristic,2000,1500,0.00037518759379689845,0.0013027000240981579,500,124752
MMG,2000,1500,0.00037518759379689845,0.4629500999581069,500,124752
SoA heuristic,4000,3000,0.00018754688672168043,0.0021246999967843294,1000,499563
MMG,4000,3000,0.00018754688672168043,1.9703697999939322,1000,499563
SoA heuristic,8000,6000,9.376172021502688e-05,0.06367870001122355,2000,1999647
MMG,8000,6000,9.376172021502688e-05,7.869265899993479,2000,1999647
SoA heuristic,20,15,0.039473684210526314,3.2700132578611374e-05,5,14
MMG,20,15,0.039473684210526314,0.00015849992632865906,5,14
SoA heuristic,40,30,0.019230769230769232,2.9199989512562752e-05,10,44
MMG,40,30,0.019230769230769232,0.00022660009562969208,10,44
SoA heuristic,100,75,0.007575757575757576,0.00012909993529319763,25,323
MMG,100,75,0.007575757575757576,0.0020125999581068754,25,323
SoA heuristic,200,150,0.0037688442211055275,0.00010009994730353355,50,1248
MMG,200,150,0.0037688442211055275,0.003145999973639846,50,1248
SoA heuristic,400,300,0.0018796992481203006,0.0005588999483734369,100,4983
MMG,400,300,0.0018796992481203006,0.03427309985272586,100,4983
SoA heuristic,600,450,0.0012520868113522537,0.0006124000065028667,150,11231
MMG,600,450,0.0012520868113522537,0.04285639990121126,150,11231
SoA heuristic,1000,750,0.0007507507507507507,0.0019129000138491392,250,31224
MMG,1000,750,0.0007507507507507507,0.14447559998370707,250,31224
SoA heuristic,2000,1500,0.00037518759379689845,0.0012000000569969416,500,124992
MMG,2000,1500,0.00037518759379689845,0.3589218999259174,500,124992
SoA heuristic,4000,3000,0.00018754688672168043,0.0020346001256257296,1000,500157
MMG,4000,3000,0.00018754688672168043,1.6415289000142366,1000,500157
SoA heuristic,8000,6000,9.376172021502688e-05,0.061411599861457944,2000,2000841
MMG,8000,6000,9.376172021502688e-05,8.036965699866414,2000,2000841
