name,nodes,edges,density,time,result_set,result_w
SoA heuristic,20,15,0.039473684210526314,1.8999911844730377e-05,5,30
MMG,20,15,0.039473684210526314,9.039998985826969e-05,5,30
SoA heuristic,40,30,0.019230769230769232,2.8300099074840546e-05,10,108
MMG,40,30,0.019230769230769232,0.00021949992515146732,10,108
SoA heuristic,100,75,0.007575757575757576,5.510007031261921e-05,25,646
MMG,100,75,0.007575757575757576,0.0009262000676244497,25,646
SoA heuristic,200,150,0.0037688442211055275,0.00011099991388618946,50,2608
MMG,200,150,0.0037688442211055275,0.003423399990424514,50,2608
SoA heuristic,400,300,0.0018796992481203006,0.00019689998589456081,100,9941
MMG,400,300,0.0018796992481203006,0.012287599965929985,100,9941
SoA heuristic,600,450,0.0012520868113522537,0.0002842999529093504,150,22673
MMG,600,450,0.0012520868113522537,0.0277623999863863,150,22673
SoA heuristic,1000,750,0.0007507507507507507,0.0005435000639408827,250,62396
MMG,1000,750,0.0007507507507507507,0.07604179996997118,250,62396
SoA heuristic,2000,1500,0.00037518759379689845,0.0011264001950621605,500,249444
MMG,2000,1500,0.00037518759379689845,0.2986940999981016,500,249444
SoA heuristic,4000,3000,0.00018754688672168043,0.0025239000096917152,1000,998706
MMG,4000,3000,0.00018754688672168043,1.205949299968779,1000,998706
SoA heuristic,8000,6000,9.376172021502688e-05,0.005090200109407306,2000,4001795
MMG,8000,6000,9.376172021502688e-05,4.828436800045893,2000,4001795
SoA heuristic,20,15,0.039473684210526314,1.950003206729889e-05,5,23
MMG,20,15,0.039473684210526314,9.320001117885113e-05,5,23
SoA heuristic,40,30,0.019230769230769232,3.160000778734684e-05,10,105
MMG,40,30,0.019230769230769232,0.0002454000059515238,10,105
SoA heuristic,100,75,0.007575757575757576,5.519995465874672e-05,25,600
MMG,100,75,0.007575757575757576,0.0009472998790442944,25,600
SoA heuristic,200,150,0.0037688442211055275,0.00011099991388618946,50,2451
MMG,200,150,0.0037688442211055275,0.0034078999888151884,50,2451
SoA heuristic,400,300,0.0018796992481203006,0.00020999996922910213,100,9828
MMG,400,300,0.0018796992481203006,0.012819899944588542,100,9828
SoA heuristic,600,450,0.0012520868113522537,0.00030239997431635857,150,22471
MMG,600,450,0.0012520868113522537,0.02776059997268021,150,22471
SoA heuristic,1000,750,0.0007507507507507507,0.0004909001290798187,250,63253
MMG,1000,750,0.0007507507507507507,0.06789219984784722,250,63253
SoA heuristic,2000,1500,0.00037518759379689845,0.0010989001020789146,500,250139
MMG,2000,1500,0.00037518759379689845,0.2958854001481086,500,250139
SoA heuristic,4000,3000,0.00018754688672168043,0.0021742000244557858,1000,1001076
MMG,4000,3000,0.00018754688672168043,1.1708750000689179,1000,1001076
SoA heuristic,8000,6000,9.376172021502688e-05,0.00523460004478693,2000,3999775
MMG,8000,6000,9.376172021502688e-05,4.754685000050813,2000,3999775
SoA heuristic,20,15,0.039473684210526314,2.2500054910779e-05,5,28
MMG,20,15,0.039473684210526314,0.00012609991244971752,5,28
SoA heuristic,40,30,0.019230769230769232,3.369990736246109e-05,10,94
MMG,40,30,0.019230769230769232,0.00023000012151896954,10,94
SoA heuristic,100,75,0.007575757575757576,5.6499848142266273e-05,25,650
MMG,100,75,0.007575757575757576,0.0009314001072198153,25,650
SoA heuristic,200,150,0.0037688442211055275,0.00010939990170300007,50,2495
MMG,200,150,0.0037688442211055275,0.003421999979764223,50,2495
SoA heuristic,400,300,0.0018796992481203006,0.00020749983377754688,100,9952
MMG,400,300,0.0018796992481203006,0.012590300058946013,100,9952
SoA heuristic,600,450,0.0012520868113522537,0.0003054998815059662,150,22236
MMG,600,450,0.0012520868113522537,0.027921699918806553,150,22236
SoA heuristic,1000,750,0.0007507507507507507,0.0005181999877095222,250,62784
MMG,1000,750,0.0007507507507507507,0.07494399999268353,250,62784
SoA heuristic,2000,1500,0.00037518759379689845,0.0011187999043613672,500,249091
MMG,2000,1500,0.00037518759379689845,0.29565300000831485,500,249091
SoA heuristic,4000,3000,0.00018754688672168043,0.00258089997805655,1000,1001322
MMG,4000,3000,0.00018754688672168043,1.2103412998840213,1000,1001322
SoA heuristic,8000,6000,9.376172021502688e-05,0.005144499940797687,2000,3997395
MMG,8000,6000,9.376172021502688e-05,4.786435700021684,2000,3997395
SoA heuristic,20,15,0.039473684210526314,2.0799925550818443e-05,5,31
MMG,20,15,0.039473684210526314,9.569991379976273e-05,5,31
SoA heuristic,40,30,0.019230769230769232,3.0199997127056122e-05,10,107
MMG,40,30,0.019230769230769232,0.00023079989477992058,10,107
SoA heuristic,100,75,0.007575757575757576,5.8300094678997993e-05,25,625
MMG,100,75,0.007575757575757576,0.0009755000937730074,25,625
SoA heuristic,200,150,0.0037688442211055275,0.00010740011930465698,50,2599
MMG,200,150,0.0037688442211055275,0.003189900191500783,50,2599
SoA heuristic,400,300,0.0018796992481203006,0.00020759995095431805,100,9846
MMG,400,300,0.0018796992481203006,0.013200900051742792,100,9846
SoA heuristic,600,450,0.0012520868113522537,0.00029719993472099304,150,22589
MMG,600,450,0.0012520868113522537,0.02798129990696907,150,22589
SoA heuristic,1000,750,0.0007507507507507507,0.0005125999450683594,250,62380
MMG,1000,750,0.0007507507507507507,0.07569670001976192,250,62380
SoA heuristic,2000,1500,0.00037518759379689845,0.0011036999057978392,500,250373
MMG,2000,1500,0.00037518759379689845,0.29912229999899864,500,250373
SoA heuristic,4000,3000,0.00018754688672168043,0.0021806000731885433,1000,1000001
MMG,4000,3000,0.00018754688672168043,1.1860245999414474,1000,1000001
SoA heuristic,8000,6000,9.376172021502688e-05,0.04334570001810789,2000,3996507
MMG,8000,6000,9.376172021502688e-05,7.443118500057608,2000,3996507
SoA heuristic,20,15,0.039473684210526314,2.650008536875248e-05,5,23
MMG,20,15,0.039473684210526314,0.00012700003571808338,5,23
SoA heuristic,40,30,0.019230769230769232,2.7700094506144524e-05,10,92
MMG,40,30,0.019230769230769232,0.00022210017777979374,10,92
SoA heuristic,100,75,0.007575757575757576,5.560019053518772e-05,25,624
MMG,100,75,0.007575757575757576,0.0009525001514703035,25,624
SoA heuristic,200,150,0.0037688442211055275,9.75998118519783e-05,50,2520
MMG,200,150,0.0037688442211055275,0.003215199802070856,50,2520
SoA heuristic,400,300,0.0018796992481203006,0.00018189987167716026,100,10089
MMG,400,300,0.0018796992481203006,0.01792869996279478,100,10089
SoA heuristic,600,450,0.0012520868113522537,0.0003128999378532171,150,22554
MMG,600,450,0.0012520868113522537,0.038382899947464466,150,22554
SoA heuristic,1000,750,0.0007507507507507507,0.0008135999087244272,250,62391
MMG,1000,750,0.0007507507507507507,0.08736130013130605,250,62391
SoA heuristic,2000,1500,0.00037518759379689845,0.003098800079897046,500,249663
MMG,2000,1500,0.00037518759379689845,0.47341959993354976,500,249663
SoA heuristic,4000,3000,0.00018754688672168043,0.003406000090762973,1000,999152
MMG,4000,3000,0.00018754688672168043,1.7506107999943197,1000,999152
SoA heuristic,8000,6000,9.376172021502688e-05,0.007363300072029233,2000,3998157
MMG,8000,6000,9.376172021502688e-05,6.673507699975744,2000,3998157
SoA heuristic,20,15,0.039473684210526314,2.4099834263324738e-05,5,26
MMG,20,15,0.039473684210526314,0.00010660011321306229,5,26
SoA heuristic,40,30,0.019230769230769232,3.0499882996082306e-05,10,99
MMG,40,30,0.019230769230769232,0.00023539992980659008,10,99
SoA heuristic,100,75,0.007575757575757576,5.460018292069435e-05,25,638
MMG,100,75,0.007575757575757576,0.000946700107306242,25,638
SoA heuristic,200,150,0.0037688442211055275,0.00010240008123219013,50,2486
MMG,200,150,0.0037688442211055275,0.0032812999561429024,50,2486
SoA heuristic,400,300,0.0018796992481203006,0.0001976999919861555,100,10077
MMG,400,300,0.0018796992481203006,0.012438199948519468,100,10077
SoA heuristic,600,450,0.0012520868113522537,0.0002949000336229801,150,22570
MMG,600,450,0.0012520868113522537,0.02743660006672144,150,22570
SoA heuristic,1000,750,0.0007507507507507507,0.000501799862831831,250,62681
MMG,1000,750,0.0007507507507507507,0.07415200001560152,250,62681
SoA heuristic,2000,1500,0.00037518759379689845,0.0010939999483525753,500,249140
MMG,2000,1500,0.00037518759379689845,0.2952322999481112,500,249140
SoA heuristic,4000,3000,0.00018754688672168043,0.002267699921503663,1000,1001029
MMG,4000,3000,0.00018754688672168043,1.1656669001094997,1000,1001029
SoA heuristic,8000,6000,9.376172021502688e-05,0.004316800041124225,2000,4003484
MMG,8000,6000,9.376172021502688e-05,4.725017599994317,2000,4003484
SoA heuristic,20,15,0.039473684210526314,2.1999934688210487e-05,5,25
MMG,20,15,0.039473684210526314,9.75998118519783e-05,5,25
SoA heuristic,40,30,0.019230769230769232,3.2400013878941536e-05,10,91
MMG,40,30,0.019230769230769232,0.0002546999603509903,10,91
SoA heuristic,100,75,0.007575757575757576,6.24998938292265e-05,25,618
MMG,100,75,0.007575757575757576,0.000994799891486764,25,618
SoA heuristic,200,150,0.0037688442211055275,0.00010120007209479809,50,2478
MMG,200,150,0.0037688442211055275,0.003051299834623933,50,2478
SoA heuristic,400,300,0.0018796992481203006,0.000201700022444129,100,9861
MMG,400,300,0.0018796992481203006,0.012661700136959553,100,9861
SoA heuristic,600,450,0.0012520868113522537,0.0002983000595122576,150,22798
MMG,600,450,0.0012520868113522537,0.02716649998910725,150,22798
SoA heuristic,1000,750,0.0007507507507507507,0.0005040999967604876,250,62439
MMG,1000,750,0.0007507507507507507,0.07550540007650852,250,62439
SoA heuristic,2000,1500,0.00037518759379689845,0.0011153998784720898,500,250477
MMG,2000,1500,0.00037518759379689845,0.2968784000258893,500,250477
SoA heuristic,4000,3000,0.00018754688672168043,0.0026436999905854464,1000,999778
MMG,4000,3000,0.00018754688672168043,1.193554300116375,1000,999778
SoA heuristic,8000,6000,9.376172021502688e-05,0.005082699935883284,2000,3999720
MMG,8000,6000,9.376172021502688e-05,4.878826999804005,2000,3999720
SoA heuristic,20,15,0.039473684210526314,2.6999972760677338e-05,5,24
MMG,20,15,0.039473684210526314,8.970010094344616e-05,5,24
SoA heuristic,40,30,0.019230769230769232,2.8799986466765404e-05,10,94
MMG,40,30,0.019230769230769232,0.0002256000880151987,10,94
SoA heuristic,100,75,0.007575757575757576,5.759997293353081e-05,25,596
MMG,100,75,0.007575757575757576,0.0009375999215990305,25,596
SoA heuristic,200,150,0.0037688442211055275,0.00010469998233020306,50,2502
MMG,200,150,0.0037688442211055275,0.0033585999626666307,50,2502
SoA heuristic,400,300,0.0018796992481203006,0.00020050001330673695,100,10138
MMG,400,300,0.0018796992481203006,0.01253549987450242,100,10138
SoA heuristic,600,450,0.0012520868113522537,0.0002988001797348261,150,22517
MMG,600,450,0.0012520868113522537,0.027708500158041716,150,22517
SoA heuristic,1000,750,0.0007507507507507507,0.0004994000773876905,250,62251
MMG,1000,750,0.0007507507507507507,0.07481690007261932,250,62251
SoA heuristic,2000,1500,0.00037518759379689845,0.001142699969932437,500,250190
MMG,2000,1500,0.00037518759379689845,0.2964590999763459,500,250190
SoA heuristic,4000,3000,0.00018754688672168043,0.0021938998252153397,1000,1000357
MMG,4000,3000,0.00018754688672168043,1.1966514000669122,1000,1000357
SoA heuristic,8000,6000,9.376172021502688e-05,0.03296049986965954,2000,3995077
MMG,8000,6000,9.376172021502688e-05,4.84459610003978,2000,3995077
SoA heuristic,20,15,0.039473684210526314,2.9799994081258774e-05,5,24
MMG,20,15,0.039473684210526314,9.660003706812859e-05,5,24
SoA heuristic,40,30,0.019230769230769232,2.8999987989664078e-05,10,104
MMG,40,30,0.019230769230769232,0.0002351999282836914,10,104
SoA heuristic,100,75,0.007575757575757576,5.8499863371253014e-05,25,588
MMG,100,75,0.007575757575757576,0.0009689999278634787,25,588
SoA heuristic,200,150,0.0037688442211055275,0.0001042000949382782,50,2431
MMG,200,150,0.0037688442211055275,0.003239499870687723,50,2431
SoA heuristic,400,300,0.0018796992481203006,0.00020510004833340645,100,10033
MMG,400,300,0.0018796992481203006,0.011724299984052777,100,10033
SoA heuristic,600,450,0.0012520868113522537,0.00030550011433660984,150,22497
MMG,600,450,0.0012520868113522537,0.027757200179621577,150,22497
SoA heuristic,1000,750,0.0007507507507507507,0.0005000000819563866,250,62592
MMG,1000,750,0.0007507507507507507,0.07520950003527105,250,62592
SoA heuristic,2000,1500,0.00037518759379689845,0.0010875998996198177,500,249856
MMG,2000,1500,0.00037518759379689845,0.2809176000300795,500,249856
SoA heuristic,4000,3000,0.00018754688672168043,0.0021304001566022635,1000,999806
MMG,4000,3000,0.00018754688672168043,1.1985987001098692,1000,999806
SoA heuristic,8000,6000,9.376172021502688e-05,0.0045779999345541,2000,3999920
MMG,8000,6000,9.376172021502688e-05,4.682839199900627,2000,3999920
SoA heuristic,20,15,0.039473684210526314,2.519995905458927e-05,5,17
MMG,20,15,0.039473684210526314,0.00010979990474879742,5,17
SoA heuristic,40,30,0.019230769230769232,2.9399991035461426e-05,10,108
MMG,40,30,0.019230769230769232,0.00023310002870857716,10,108
SoA heuristic,100,75,0.007575757575757576,6.209989078342915e-05,25,633
MMG,100,75,0.007575757575757576,0.00101169990375638,25,633
SoA heuristic,200,150,0.0037688442211055275,0.00010480009950697422,50,2466
MMG,200,150,0.0037688442211055275,0.0032728000078350306,50,2466
SoA heuristic,400,300,0.0018796992481203006,0.00020079989917576313,100,9860
MMG,400,300,0.0018796992481203006,0.012542200041934848,100,9860
SoA heuristic,600,450,0.0012520868113522537,0.0003144999500364065,150,22574
MMG,600,450,0.0012520868113522537,0.0282024999614805,150,22574
SoA heuristic,1000,750,0.0007507507507507507,0.0005038999952375889,250,62351
MMG,1000,750,0.0007507507507507507,0.07548599992878735,250,62351
SoA heuristic,2000,1500,0.00037518759379689845,0.0011160001158714294,500,249375
MMG,2000,1500,0.00037518759379689845,0.2957828000653535,500,249375
SoA heuristic,4000,3000,0.00018754688672168043,0.002663500141352415,1000,999806
MMG,4000,3000,0.00018754688672168043,1.218897599959746,1000,999806
SoA heuristic,8000,6000,9.376172021502688e-05,0.0045507000759243965,2000,4002379
MMG,8000,6000,9.376172021502688e-05,4.855761399958283,2000,4002379
SoA heuristic,20,15,0.039473684210526314,1.8900027498602867e-05,5,19
MMG,20,15,0.039473684210526314,9.200000204145908e-05,5,19
SoA heuristic,40,30,0.019230769230769232,8.350005373358727e-05,10,113
MMG,40,30,0.019230769230769232,0.0006353999488055706,10,113
SoA heuristic,100,75,0.007575757575757576,5.45999500900507e-05,25,664
MMG,100,75,0.007575757575757576,0.0008962000720202923,25,664
SoA heuristic,200,150,0.0037688442211055275,0.00013040006160736084,50,2467
MMG,200,150,0.0037688442211055275,0.0030773000326007605,50,2467
SoA heuristic,400,300,0.0018796992481203006,0.0001900000497698784,100,9980
MMG,400,300,0.0018796992481203006,0.012471300084143877,100,9980
SoA heuristic,600,450,0.0012520868113522537,0.0006315999198704958,150,22519
MMG,600,450,0.0012520868113522537,0.0390196000225842,150,22519
SoA heuristic,1000,750,0.0007507507507507507,0.000497099943459034,250,62061
MMG,1000,750,0.0007507507507507507,0.11778400000184774,250,62061
SoA heuristic,2000,1500,0.00037518759379689845,0.00102499988861382,500,249859
MMG,2000,1500,0.00037518759379689845,0.3896888999734074,500,249859
SoA heuristic,4000,3000,0.00018754688672168043,0.0021108000073581934,1000,1000724
MMG,4000,3000,0.00018754688672168043,1.4755649000871927,1000,1000724
SoA heuristic,8000,6000,9.376172021502688e-05,0.011769299861043692,2000,3999162
MMG,8000,6000,9.376172021502688e-05,6.330929399933666,2000,3999162
SoA heuristic,20,15,0.039473684210526314,9.189988486468792e-05,5,20
MMG,20,15,0.039473684210526314,0.0004811000544577837,5,20
SoA heuristic,40,30,0.019230769230769232,2.719997428357601e-05,10,97
MMG,40,30,0.019230769230769232,0.00022080005146563053,10,97
SoA heuristic,100,75,0.007575757575757576,5.2900053560733795e-05,25,648
MMG,100,75,0.007575757575757576,0.0009000999853014946,25,648
SoA heuristic,200,150,0.0037688442211055275,0.00035530002787709236,50,2549
MMG,200,150,0.0037688442211055275,0.008988600224256516,50,2549
SoA heuristic,400,300,0.0018796992481203006,0.00018569990061223507,100,9982
MMG,400,300,0.0018796992481203006,0.020483100088313222,100,9982
SoA heuristic,600,450,0.0012520868113522537,0.00027660001069307327,150,22374
MMG,600,450,0.0012520868113522537,0.026469700038433075,150,22374
SoA heuristic,1000,750,0.0007507507507507507,0.0009137999732047319,250,62385
MMG,1000,750,0.0007507507507507507,0.14861769997514784,250,62385
SoA heuristic,2000,1500,0.00037518759379689845,0.0010512000881135464,500,249761
MMG,2000,1500,0.00037518759379689845,0.5053457000758499,500,249761
SoA heuristic,4000,3000,0.00018754688672168043,0.0019739000126719475,1000,999998
MMG,4000,3000,0.00018754688672168043,1.8974497001618147,1000,999998
SoA heuristic,8000,6000,9.376172021502688e-05,0.04452609992586076,2000,4001470
MMG,8000,6000,9.376172021502688e-05,6.396204800112173,2000,4001470
SoA heuristic,20,15,0.039473684210526314,1.8300022929906845e-05,5,15
MMG,20,15,0.039473684210526314,9.010010398924351e-05,5,15
SoA heuristic,40,30,0.019230769230769232,3.0800001695752144e-05,10,78
MMG,40,30,0.019230769230769232,0.0002305998932570219,10,78
SoA heuristic,100,75,0.007575757575757576,0.00015520001761615276,25,639
MMG,100,75,0.007575757575757576,0.001268099993467331,25,639
SoA heuristic,200,150,0.0037688442211055275,0.00011030002497136593,50,2462
MMG,200,150,0.0037688442211055275,0.003269899869337678,50,2462
SoA heuristic,400,300,0.0018796992481203006,0.00036390009336173534,100,9984
MMG,400,300,0.0018796992481203006,0.014781799865886569,100,9984
SoA heuristic,600,450,0.0012520868113522537,0.00031589996069669724,150,22528
MMG,600,450,0.0012520868113522537,0.02720230002887547,150,22528
SoA heuristic,1000,750,0.0007507507507507507,0.00047350022941827774,250,62476
MMG,1000,750,0.0007507507507507507,0.0809851000085473,250,62476
SoA heuristic,2000,1500,0.00037518759379689845,0.0011844998225569725,500,250429
MMG,2000,1500,0.00037518759379689845,0.3918745999690145,500,250429
SoA heuristic,4000,3000,0.00018754688672168043,0.0024936001282185316,1000,998488
MMG,4000,3000,0.00018754688672168043,1.3964252001605928,1000,998488
SoA heuristic,8000,6000,9.376172021502688e-05,0.004413400078192353,2000,4001062
MMG,8000,6000,9.376172021502688e-05,6.609938899986446,2000,4001062
SoA heuristic,20,15,0.039473684210526314,2.0999927073717117e-05,5,23
MMG,20,15,0.039473684210526314,9.66999214142561e-05,5,23
SoA heuristic,40,30,0.019230769230769232,4.229997284710407e-05,10,94
MMG,40,30,0.019230769230769232,0.0003573000431060791,10,94
SoA heuristic,100,75,0.007575757575757576,6.589991971850395e-05,25,639
MMG,100,75,0.007575757575757576,0.0009624001104384661,25,639
SoA heuristic,200,150,0.0037688442211055275,0.00014779996126890182,50,2482
MMG,200,150,0.0037688442211055275,0.004583100089803338,50,2482
SoA heuristic,400,300,0.0018796992481203006,0.00038480013608932495,100,9948
MMG,400,300,0.0018796992481203006,0.026864799903705716,100,9948
SoA heuristic,600,450,0.0012520868113522537,0.00031949998810887337,150,22302
MMG,600,450,0.0012520868113522537,0.027099299943074584,150,22302
SoA heuristic,1000,750,0.0007507507507507507,0.0005055000074207783,250,62034
MMG,1000,750,0.0007507507507507507,0.08697919989936054,250,62034
SoA heuristic,2000,1500,0.00037518759379689845,0.0031322999857366085,500,249859
MMG,2000,1500,0.00037518759379689845,0.41638219985179603,500,249859
SoA heuristic,4000,3000,0.00018754688672168043,0.002037100028246641,1000,998947
MMG,4000,3000,0.00018754688672168043,1.6113899999763817,1000,998947
SoA heuristic,8000,6000,9.376172021502688e-05,0.048868900164961815,2000,3998499
MMG,8000,6000,9.376172021502688e-05,6.613663699943572,2000,3998499
SoA heuristic,20,15,0.039473684210526314,2.310005947947502e-05,5,34
MMG,20,15,0.039473684210526314,0.00011440017260611057,5,34
SoA heuristic,40,30,0.019230769230769232,2.7399975806474686e-05,10,95
MMG,40,30,0.019230769230769232,0.00022229994647204876,10,95
SoA heuristic,100,75,0.007575757575757576,5.6900084018707275e-05,25,607
MMG,100,75,0.007575757575757576,0.0009151999838650227,25,607
SoA heuristic,200,150,0.0037688442211055275,0.00015769992023706436,50,2470
MMG,200,150,0.0037688442211055275,0.0035357000306248665,50,2470
SoA heuristic,400,300,0.0018796992481203006,0.0006587998941540718,100,10087
MMG,400,300,0.0018796992481203006,0.02171859983354807,100,10087
SoA heuristic,600,450,0.0012520868113522537,0.00028130016289651394,150,22782
MMG,600,450,0.0012520868113522537,0.028066099854186177,150,22782
SoA heuristic,1000,750,0.0007507507507507507,0.0005405999254435301,250,63135
MMG,1000,750,0.0007507507507507507,0.11403869977220893,250,63135
SoA heuristic,2000,1500,0.00037518759379689845,0.0010432000271975994,500,251190
MMG,2000,1500,0.00037518759379689845,0.3488713998813182,500,251190
SoA heuristic,4000,3000,0.00018754688672168043,0.002017199993133545,1000,999602
MMG,4000,3000,0.00018754688672168043,1.9289698000065982,1000,999602
SoA heuristic,8000,6000,9.376172021502688e-05,0.008371500065550208,2000,4002144
MMG,8000,6000,9.376172021502688e-05,6.742284700041637,2000,4002144
SoA heuristic,20,15,0.039473684210526314,2.7999980375170708e-05,5,25
MMG,20,15,0.039473684210526314,0.0001401000190526247,5,25
SoA heuristic,40,30,0.019230769230769232,4.429998807609081e-05,10,88
MMG,40,30,0.019230769230769232,0.00022529996931552887,10,88
SoA heuristic,100,75,0.007575757575757576,5.3900061175227165e-05,25,657
MMG,100,75,0.007575757575757576,0.0009119999594986439,25,657
SoA heuristic,200,150,0.0037688442211055275,0.00019859988242387772,50,2498
MMG,200,150,0.0037688442211055275,0.007749899988994002,50,2498
SoA heuristic,400,300,0.0018796992481203006,0.0001829001121222973,100,9924
MMG,400,300,0.0018796992481203006,0.02125200000591576,100,9924
SoA heuristic,600,450,0.0012520868113522537,0.0002718998584896326,150,22517
MMG,600,450,0.0012520868113522537,0.02540059993043542,150,22517
SoA heuristic,1000,750,0.0007507507507507507,0.00045350007712841034,250,61997
MMG,1000,750,0.0007507507507507507,0.09607279999181628,250,61997
SoA heuristic,2000,1500,0.00037518759379689845,0.0010798999574035406,500,250288
MMG,2000,1500,0.00037518759379689845,0.469143700087443,500,250288
SoA heuristic,4000,3000,0.00018754688672168043,0.006020399974659085,1000,1001487
MMG,4000,3000,0.00018754688672168043,2.007477100007236,1000,1001487
SoA heuristic,8000,6000,9.376172021502688e-05,0.004516000160947442,2000,4001111
MMG,8000,6000,9.376172021502688e-05,7.271747600054368,2000,4001111
SoA heuristic,20,15,0.039473684210526314,6.0499878600239754e-05,5,14
MMG,20,15,0.039473684210526314,0.00032979995012283325,5,14
SoA heuristic,40,30,0.019230769230769232,3.3800024539232254e-05,10,114
MMG,40,30,0.019230769230769232,0.00024010008201003075,10,114
SoA heuristic,100,75,0.007575757575757576,5.3799943998456e-05,25,647
MMG,100,75,0.007575757575757576,0.0009067000355571508,25,647
SoA heuristic,200,150,0.0037688442211055275,0.00014420016668736935,50,2533
MMG,200,150,0.0037688442211055275,0.0037399998400360346,50,2533
SoA heuristic,400,300,0.0018796992481203006,0.00018269987776875496,100,9998
MMG,400,300,0.0018796992481203006,0.029678199905902147,100,9998
SoA heuristic,600,450,0.0012520868113522537,0.0003028998617082834,150,22373
MMG,600,450,0.0012520868113522537,0.03564180014654994,150,22373
SoA heuristic,1000,750,0.0007507507507507507,0.0008499000687152147,250,62458
MMG,1000,750,0.0007507507507507507,0.12591339997015893,250,62458
SoA heuristic,2000,1500,0.00037518759379689845,0.0026645001489669085,500,251060
MMG,2000,1500,0.00037518759379689845,0.4898333998862654,500,251060
SoA heuristic,4000,3000,0.00018754688672168043,0.0024387999437749386,1000,1002974
MMG,4000,3000,0.00018754688672168043,1.795274600153789,1000,1002974
SoA heuristic,8000,6000,9.376172021502688e-05,0.006389799993485212,2000,4000415
MMG,8000,6000,9.376172021502688e-05,7.446666999952868,2000,4000415
SoA heuristic,20,15,0.039473684210526314,2.0899809896945953e-05,5,25
MMG,20,15,0.039473684210526314,8.989986963570118e-05,5,25
SoA heuristic,40,30,0.019230769230769232,2.7999980375170708e-05,10,82
MMG,40,30,0.019230769230769232,0.00021749990992248058,10,82
SoA heuristic,100,75,0.007575757575757576,5.970010533928871e-05,25,627
MMG,100,75,0.007575757575757576,0.0009934999980032444,25,627
SoA heuristic,200,150,0.0037688442211055275,0.00018410012125968933,50,2555
MMG,200,150,0.0037688442211055275,0.007548799971118569,50,2555
SoA heuristic,400,300,0.0018796992481203006,0.00019580009393393993,100,10081
MMG,400,300,0.0018796992481203006,0.021531800040975213,100,10081
SoA heuristic,600,450,0.0012520868113522537,0.00026759994216263294,150,22659
MMG,600,450,0.0012520868113522537,0.029737200122326612,150,22659
SoA heuristic,1000,750,0.0007507507507507507,0.00045779999345541,250,62480
MMG,1000,750,0.0007507507507507507,0.08872390002943575,250,62480
SoA heuristic,2000,1500,0.00037518759379689845,0.0010373999830335379,500,249302
MMG,2000,1500,0.00037518759379689845,0.4410512000322342,500,249302
SoA heuristic,4000,3000,0.00018754688672168043,0.0035070001613348722,1000,998470
MMG,4000,3000,0.00018754688672168043,1.5677732999902219,1000,998470
SoA heuristic,8000,6000,9.376172021502688e-05,0.04337030020542443,2000,3999545
MMG,8000,6000,9.376172021502688e-05,6.964742199983448,2000,3999545
SoA heuristic,20,15,0.039473684210526314,1.950003206729889e-05,5,25
MMG,20,15,0.039473684210526314,0.00010639987885951996,5,25
SoA heuristic,40,30,0.019230769230769232,2.859998494386673e-05,10,82
MMG,40,30,0.019230769230769232,0.00022109993733465672,10,82
SoA heuristic,100,75,0.007575757575757576,0.00012560002505779266,25,642
MMG,100,75,0.007575757575757576,0.0022466001100838184,25,642
SoA heuristic,200,150,0.0037688442211055275,9.67998057603836e-05,50,2473
MMG,200,150,0.0037688442211055275,0.0036038001999258995,50,2473
SoA heuristic,400,300,0.0018796992481203006,0.0005620999727398157,100,9887
MMG,400,300,0.0018796992481203006,0.022907900158315897,100,9887
SoA heuristic,600,450,0.0012520868113522537,0.0002989000640809536,150,22455
MMG,600,450,0.0012520868113522537,0.034198000095784664,150,22455
SoA heuristic,1000,750,0.0007507507507507507,0.0005637998692691326,250,62656
MMG,1000,750,0.0007507507507507507,0.10486610000953078,250,62656
SoA heuristic,2000,1500,0.00037518759379689845,0.0010522000957280397,500,250526
MMG,2000,1500,0.00037518759379689845,0.41952200001105666,500,250526
SoA heuristic,4000,3000,0.00018754688672168043,0.0025962998624891043,1000,1001331
MMG,4000,3000,0.00018754688672168043,1.3981228000484407,1000,1001331
SoA heuristic,8000,6000,9.376172021502688e-05,0.004337700083851814,2000,3998273
MMG,8000,6000,9.376172021502688e-05,6.8711439000908285,2000,3998273
SoA heuristic,20,15,0.039473684210526314,7.429998368024826e-05,5,22
MMG,20,15,0.039473684210526314,0.000264700036495924,5,22
SoA heuristic,40,30,0.019230769230769232,0.0001504998654127121,10,96
MMG,40,30,0.019230769230769232,0.00104490015655756,10,96
SoA heuristic,100,75,0.007575757575757576,7.16999638825655e-05,25,623
MMG,100,75,0.007575757575757576,0.0009558999445289373,25,623
SoA heuristic,200,150,0.0037688442211055275,9.949994273483753e-05,50,2560
MMG,200,150,0.0037688442211055275,0.0031260999385267496,50,2560
SoA heuristic,400,300,0.0018796992481203006,0.00019330019131302834,100,9879
MMG,400,300,0.0018796992481203006,0.015645999927073717,100,9879
SoA heuristic,600,450,0.0012520868113522537,0.0008495999500155449,150,22780
MMG,600,450,0.0012520868113522537,0.0544388999696821,150,22780
SoA heuristic,1000,750,0.0007507507507507507,0.0012164998333901167,250,62516
MMG,1000,750,0.0007507507507507507,0.08153040008619428,250,62516
SoA heuristic,2000,1500,0.00037518759379689845,0.0011573999654501677,500,250055
MMG,2000,1500,0.00037518759379689845,0.37933170003816485,500,250055
SoA heuristic,4000,3000,0.00018754688672168043,0.003905500052496791,1000,998996
MMG,4000,3000,0.00018754688672168043,1.682067799847573,1000,998996
SoA heuristic,8000,6000,9.376172021502688e-05,0.06374749983660877,2000,3999176
MMG,8000,6000,9.376172021502688e-05,7.2007120999041945,2000,3999176
SoA heuristic,20,15,0.039473684210526314,2.050003968179226e-05,5,22
MMG,20,15,0.039473684210526314,9.139999747276306e-05,5,22
SoA heuristic,40,30,0.019230769230769232,3.600004129111767e-05,10,116
MMG,40,30,0.019230769230769232,0.00028529996052384377,10,116
SoA heuristic,100,75,0.007575757575757576,0.00018070009537041187,25,641
MMG,100,75,0.007575757575757576,0.0029676000121980906,25,641
SoA heuristic,200,150,0.0037688442211055275,9.8800053820014e-05,50,2518
MMG,200,150,0.0037688442211055275,0.007896099938079715,50,2518
SoA heuristic,400,300,0.0018796992481203006,0.00018360000103712082,100,10029
MMG,400,300,0.0018796992481203006,0.028204899979755282,100,10029
SoA heuristic,600,450,0.0012520868113522537,0.00027909991331398487,150,22553
MMG,600,450,0.0012520868113522537,0.060916699934750795,150,22553
SoA heuristic,1000,750,0.0007507507507507507,0.0004561999812722206,250,62131
MMG,1000,750,0.0007507507507507507,0.10170060000382364,250,62131
SoA heuristic,2000,1500,0.00037518759379689845,0.0031253998167812824,500,249737
MMG,2000,1500,0.00037518759379689845,0.42978729982860386,500,249737
SoA heuristic,4000,3000,0.00018754688672168043,0.002055099932476878,1000,1000607
MMG,4000,3000,0.00018754688672168043,1.6986434999853373,1000,1000607
SoA heuristic,8000,6000,9.376172021502688e-05,0.010957099962979555,2000,4000900
MMG,8000,6000,9.376172021502688e-05,6.587176100118086,2000,4000900
SoA heuristic,20,15,0.039473684210526314,2.2300053387880325e-05,5,35
MMG,20,15,0.039473684210526314,9.80000477284193e-05,5,35
SoA heuristic,40,30,0.019230769230769232,2.850010059773922e-05,10,104
MMG,40,30,0.019230769230769232,0.00022350018844008446,10,104
SoA heuristic,100,75,0.007575757575757576,5.679996684193611e-05,25,587
MMG,100,75,0.007575757575757576,0.0009140998590737581,25,587
SoA heuristic,200,150,0.0037688442211055275,0.00010120007209479809,50,2442
MMG,200,150,0.0037688442211055275,0.003115599974989891,50,2442
SoA heuristic,400,300,0.0018796992481203006,0.00020110001787543297,100,9996
MMG,400,300,0.0018796992481203006,0.012428299989551306,100,9996
SoA heuristic,600,450,0.0012520868113522537,0.0003033000975847244,150,22558
MMG,600,450,0.0012520868113522537,0.02847500005736947,150,22558
SoA heuristic,1000,750,0.0007507507507507507,0.0005037998780608177,250,62361
MMG,1000,750,0.0007507507507507507,0.07428419985808432,250,62361
SoA heuristic,2000,1500,0.00037518759379689845,0.0011277999728918076,500,249572
MMG,2000,1500,0.00037518759379689845,0.294216200010851,500,249572
SoA heuristic,4000,3000,0.00018754688672168043,0.002168399980291724,1000,1001998
MMG,4000,3000,0.00018754688672168043,1.1840941000264138,1000,1001998
SoA heuristic,8000,6000,9.376172021502688e-05,0.03321849997155368,2000,3999352
MMG,8000,6000,9.376172021502688e-05,4.8611543998122215,2000,3999352
SoA heuristic,20,15,0.039473684210526314,2.119992859661579e-05,5,26
MMG,20,15,0.039473684210526314,0.00010180007666349411,5,26
SoA heuristic,40,30,0.019230769230769232,2.9300106689333916e-05,10,102
MMG,40,30,0.019230769230769232,0.000232999911531806,10,102
SoA heuristic,100,75,0.007575757575757576,6.140000186860561e-05,25,601
MMG,100,75,0.007575757575757576,0.0009582000784575939,25,601
SoA heuristic,200,150,0.0037688442211055275,0.00011080014519393444,50,2497
MMG,200,150,0.0037688442211055275,0.003454099874943495,50,2497
SoA heuristic,400,300,0.0018796992481203006,0.00021199998445808887,100,10160
MMG,400,300,0.0018796992481203006,0.011631199857220054,100,10160
SoA heuristic,600,450,0.0012520868113522537,0.000301100080832839,150,22432
MMG,600,450,0.0012520868113522537,0.027767200022935867,150,22432
SoA heuristic,1000,750,0.0007507507507507507,0.0004997998476028442,250,62508
MMG,1000,750,0.0007507507507507507,0.07387170009315014,250,62508
SoA heuristic,2000,1500,0.00037518759379689845,0.0011531999334692955,500,249173
MMG,2000,1500,0.00037518759379689845,0.2955832998268306,500,249173
SoA heuristic,4000,3000,0.00018754688672168043,0.0021561000030487776,1000,1000461
MMG,4000,3000,0.00018754688672168043,1.1956907999701798,1000,1000461
SoA heuristic,8000,6000,9.376172021502688e-05,0.005676599917933345,2000,3997183
MMG,8000,6000,9.376172021502688e-05,4.875052999937907,2000,3997183
SoA heuristic,20,15,0.039473684210526314,2.0799925550818443e-05,5,24
MMG,20,15,0.039473684210526314,9.720004163682461e-05,5,24
SoA heuristic,40,30,0.019230769230769232,3.0700117349624634e-05,10,91
MMG,40,30,0.019230769230769232,0.00023170001804828644,10,91
SoA heuristic,100,75,0.007575757575757576,5.9999991208314896e-05,25,650
MMG,100,75,0.007575757575757576,0.0009618999902158976,25,650
SoA heuristic,200,150,0.0037688442211055275,0.0001105000264942646,50,2554
MMG,200,150,0.0037688442211055275,0.0032935000490397215,50,2554
SoA heuristic,400,300,0.0018796992481203006,0.00018250010907649994,100,10091
MMG,400,300,0.0018796992481203006,0.011388200102373958,100,10091
SoA heuristic,600,450,0.0012520868113522537,0.00030960002914071083,150,22689
MMG,600,450,0.0012520868113522537,0.02779909991659224,150,22689
SoA heuristic,1000,750,0.0007507507507507507,0.0005113000515848398,250,62098
MMG,1000,750,0.0007507507507507507,0.0751502001658082,250,62098
SoA heuristic,2000,1500,0.00037518759379689845,0.0011826998088508844,500,250811
MMG,2000,1500,0.00037518759379689845,0.2955239999573678,500,250811
SoA heuristic,4000,3000,0.00018754688672168043,0.002480299910530448,1000,998712
MMG,4000,3000,0.00018754688672168043,1.203039800049737,1000,998712
SoA heuristic,8000,6000,9.376172021502688e-05,0.006253199884667993,2000,4000325
MMG,8000,6000,9.376172021502688e-05,4.8156183999963105,2000,4000325
SoA heuristic,20,15,0.039473684210526314,2.3999949917197227e-05,5,23
MMG,20,15,0.039473684210526314,0.00010609999299049377,5,23
SoA heuristic,40,30,0.019230769230769232,2.8099864721298218e-05,10,97
MMG,40,30,0.019230769230769232,0.000224200077354908,10,97
SoA heuristic,100,75,0.007575757575757576,5.62998466193676e-05,25,586
MMG,100,75,0.007575757575757576,0.0009754998609423637,25,586
SoA heuristic,200,150,0.0037688442211055275,0.00010389997623860836,50,2487
MMG,200,150,0.0037688442211055275,0.003193699987605214,50,2487
SoA heuristic,400,300,0.0018796992481203006,0.00020079989917576313,100,9958
MMG,400,300,0.0018796992481203006,0.012484899954870343,100,9958
SoA heuristic,600,450,0.0012520868113522537,0.0003043999895453453,150,22510
MMG,600,450,0.0012520868113522537,0.027924599824473262,150,22510
SoA heuristic,1000,750,0.0007507507507507507,0.0005077000241726637,250,62660
MMG,1000,750,0.0007507507507507507,0.07564019993878901,250,62660
SoA heuristic,2000,1500,0.00037518759379689845,0.0011263000778853893,500,250151
MMG,2000,1500,0.00037518759379689845,0.29445470008067787,500,250151
SoA heuristic,4000,3000,0.00018754688672168043,0.0021705999970436096,1000,1000492
MMG,4000,3000,0.00018754688672168043,1.1900345999747515,1000,1000492
SoA heuristic,8000,6000,9.376172021502688e-05,0.03146309987641871,2000,3999414
MMG,8000,6000,9.376172021502688e-05,4.874671499943361,2000,3999414
SoA heuristic,20,15,0.039473684210526314,1.950003206729889e-05,5,32
MMG,20,15,0.039473684210526314,9.580003097653389e-05,5,32
SoA heuristic,40,30,0.019230769230769232,2.7999980375170708e-05,10,122
MMG,40,30,0.019230769230769232,0.00025340006686747074,10,122
SoA heuristic,100,75,0.007575757575757576,6.0499878600239754e-05,25,603
MMG,100,75,0.007575757575757576,0.0010049999691545963,25,603
SoA heuristic,200,150,0.0037688442211055275,0.0001097000204026699,50,2511
MMG,200,150,0.0037688442211055275,0.0032961000688374043,50,2511
SoA heuristic,400,300,0.0018796992481203006,0.00020979996770620346,100,10069
MMG,400,300,0.0018796992481203006,0.012587100034579635,100,10069
SoA heuristic,600,450,0.0012520868113522537,0.00030239997431635857,150,22461
MMG,600,450,0.0012520868113522537,0.027489700121805072,150,22461
SoA heuristic,1000,750,0.0007507507507507507,0.0005222999025136232,250,62741
MMG,1000,750,0.0007507507507507507,0.07474000006914139,250,62741
SoA heuristic,2000,1500,0.00037518759379689845,0.0011324998922646046,500,250098
MMG,2000,1500,0.00037518759379689845,0.2955852998420596,500,250098
SoA heuristic,4000,3000,0.00018754688672168043,0.0026509000454097986,1000,999183
MMG,4000,3000,0.00018754688672168043,1.1424250998534262,1000,999183
SoA heuristic,8000,6000,9.376172021502688e-05,0.005904899910092354,2000,4000081
MMG,8000,6000,9.376172021502688e-05,4.696793999988586,2000,4000081
SoA heuristic,20,15,0.039473684210526314,2.2999942302703857e-05,5,22
MMG,20,15,0.039473684210526314,0.00010300008580088615,5,22
SoA heuristic,40,30,0.019230769230769232,3.120000474154949e-05,10,111
MMG,40,30,0.019230769230769232,0.00023639993742108345,10,111
SoA heuristic,100,75,0.007575757575757576,6.149988621473312e-05,25,625
MMG,100,75,0.007575757575757576,0.0009852000512182713,25,625
SoA heuristic,200,150,0.0037688442211055275,0.00010999990627169609,50,2499
MMG,200,150,0.0037688442211055275,0.0034371998626738787,50,2499
SoA heuristic,400,300,0.0018796992481203006,0.0002087999600917101,100,10041
MMG,400,300,0.0018796992481203006,0.012760600075125694,100,10041
SoA heuristic,600,450,0.0012520868113522537,0.0003084999043494463,150,22606
MMG,600,450,0.0012520868113522537,0.028039100114256144,150,22606
SoA heuristic,1000,750,0.0007507507507507507,0.0006309999153017998,250,62548
MMG,1000,750,0.0007507507507507507,0.07710720016621053,250,62548
SoA heuristic,2000,1500,0.00037518759379689845,0.001132400007918477,500,250939
MMG,2000,1500,0.00037518759379689845,0.29754069983027875,500,250939
SoA heuristic,4000,3000,0.00018754688672168043,0.0027002000715583563,1000,1000974
MMG,4000,3000,0.00018754688672168043,1.1933536999858916,1000,1000974
SoA heuristic,8000,6000,9.376172021502688e-05,0.005298200063407421,2000,3998066
MMG,8000,6000,9.376172021502688e-05,4.9290944000240415,2000,3998066
SoA heuristic,20,15,0.039473684210526314,2.650008536875248e-05,5,19
MMG,20,15,0.039473684210526314,0.00017090002074837685,5,19
SoA heuristic,40,30,0.019230769230769232,3.4499913454055786e-05,10,99
MMG,40,30,0.019230769230769232,0.00033199996687471867,10,99
SoA heuristic,100,75,0.007575757575757576,7.069995626807213e-05,25,631
MMG,100,75,0.007575757575757576,0.0010045000817626715,25,631
SoA heuristic,200,150,0.0037688442211055275,0.00012429989874362946,50,2563
MMG,200,150,0.0037688442211055275,0.003581100143492222,50,2563
SoA heuristic,400,300,0.0018796992481203006,0.00020280014723539352,100,9935
MMG,400,300,0.0018796992481203006,0.0129120999481529,100,9935
SoA heuristic,600,450,0.0012520868113522537,0.000340400030836463,150,22489
MMG,600,450,0.0012520868113522537,0.02979090018197894,150,22489
SoA heuristic,1000,750,0.0007507507507507507,0.000548599986359477,250,61933
MMG,1000,750,0.0007507507507507507,0.07763430010527372,250,61933
SoA heuristic,2000,1500,0.00037518759379689845,0.001120000146329403,500,248902
MMG,2000,1500,0.00037518759379689845,0.29973559989593923,500,248902
SoA heuristic,4000,3000,0.00018754688672168043,0.0024421000853180885,1000,999991
MMG,4000,3000,0.00018754688672168043,1.2010732998605818,1000,999991
SoA heuristic,8000,6000,9.376172021502688e-05,0.03362540015950799,2000,3999093
MMG,8000,6000,9.376172021502688e-05,4.727677900111303,2000,3999093
SoA heuristic,20,15,0.039473684210526314,2.059992402791977e-05,5,17
MMG,20,15,0.039473684210526314,0.00010579987429082394,5,17
SoA heuristic,40,30,0.019230769230769232,2.9399991035461426e-05,10,99
MMG,40,30,0.019230769230769232,0.00022950000129640102,10,99
SoA heuristic,100,75,0.007575757575757576,6.140000186860561e-05,25,590
MMG,100,75,0.007575757575757576,0.0010108000133186579,25,590
SoA heuristic,200,150,0.0037688442211055275,0.00010660011321306229,50,2562
MMG,200,150,0.0037688442211055275,0.0034596999175846577,50,2562
SoA heuristic,400,300,0.0018796992481203006,0.0002093000803142786,100,10000
MMG,400,300,0.0018796992481203006,0.012872599996626377,100,10000
SoA heuristic,600,450,0.0012520868113522537,0.00030250009149312973,150,22574
MMG,600,450,0.0012520868113522537,0.028238500002771616,150,22574
SoA heuristic,1000,750,0.0007507507507507507,0.000501799862831831,250,62582
MMG,1000,750,0.0007507507507507507,0.07529970002360642,250,62582
SoA heuristic,2000,1500,0.00037518759379689845,0.0012553001288324594,500,250005
MMG,2000,1500,0.00037518759379689845,0.2788412000518292,500,250005
SoA heuristic,4000,3000,0.00018754688672168043,0.002635600045323372,1000,998573
MMG,4000,3000,0.00018754688672168043,1.2010997000616044,1000,998573
SoA heuristic,8000,6000,9.376172021502688e-05,0.004589000018313527,2000,4000542
MMG,8000,6000,9.376172021502688e-05,4.885022300062701,2000,4000542
