name,nodes,edges,density,time,result_set,result_w
SoA heuristic,20,15,0.039473684210526314,6.680004298686981e-05,5,13
MMG,20,15,0.039473684210526314,0.00026130001060664654,5,13
SoA heuristic,40,30,0.019230769230769232,9.360001422464848e-05,10,19
MMG,40,30,0.019230769230769232,0.0003535000141710043,10,19
SoA heuristic,100,75,0.007575757575757576,5.9999991208314896e-05,25,38
MMG,100,75,0.007575757575757576,0.0015284998808056116,25,38
SoA heuristic,200,150,0.0037688442211055275,0.00031219981610774994,50,114
MMG,200,150,0.0037688442211055275,0.007868899963796139,50,114
SoA heuristic,400,300,0.0018796992481203006,0.00021169986575841904,100,202
MMG,400,300,0.0018796992481203006,0.029182199854403734,100,202
SoA heuristic,600,450,0.0012520868113522537,0.0007183998823165894,150,306
MMG,600,450,0.0012520868113522537,0.07029450009576976,150,306
SoA heuristic,1000,750,0.0007507507507507507,0.001713800011202693,250,513
MMG,1000,750,0.0007507507507507507,0.10503869992680848,250,513
SoA heuristic,2000,1500,0.00037518759379689845,0.0011233999393880367,500,1017
MMG,2000,1500,0.00037518759379689845,0.4627910000272095,500,1017
SoA heuristic,4000,3000,0.00018754688672168043,0.006479900097474456,1000,1948
MMG,4000,3000,0.00018754688672168043,1.8056000000797212,1000,1948
SoA heuristic,8000,6000,9.376172021502688e-05,0.010601999936625361,2000,3972
MMG,8000,6000,9.376172021502688e-05,7.650305700022727,2000,3972
SoA heuristic,20,15,0.039473684210526314,0.00012600002810359,5,6
MMG,20,15,0.039473684210526314,0.0002351999282836914,5,6
SoA heuristic,40,30,0.019230769230769232,3.220001235604286e-05,10,28
MMG,40,30,0.019230769230769232,0.0006160000339150429,10,28
SoA heuristic,100,75,0.007575757575757576,0.00016930000856518745,25,57
MMG,100,75,0.007575757575757576,0.001608500024303794,25,57
SoA heuristic,200,150,0.0037688442211055275,0.00011349981650710106,50,92
MMG,200,150,0.0037688442211055275,0.004293499980121851,50,92
SoA heuristic,400,300,0.0018796992481203006,0.0002810999285429716,100,207
MMG,400,300,0.0018796992481203006,0.01143230008892715,100,207
SoA heuristic,600,450,0.0012520868113522537,0.00028689997270703316,150,285
MMG,600,450,0.0012520868113522537,0.028198900166898966,150,285
SoA heuristic,1000,750,0.0007507507507507507,0.0015805999282747507,250,539
MMG,1000,750,0.0007507507507507507,0.08866250002756715,250,539
SoA heuristic,2000,1500,0.00037518759379689845,0.0010865998920053244,500,1042
MMG,2000,1500,0.00037518759379689845,0.5246224000584334,500,1042
SoA heuristic,4000,3000,0.00018754688672168043,0.0022532998118549585,1000,1903
MMG,4000,3000,0.00018754688672168043,1.7746410998515785,1000,1903
SoA heuristic,8000,6000,9.376172021502688e-05,0.005454299971461296,2000,4021
MMG,8000,6000,9.376172021502688e-05,5.208416299894452,2000,4021
SoA heuristic,20,15,0.039473684210526314,2.9899878427386284e-05,5,8
MMG,20,15,0.039473684210526314,0.00010120007209479809,5,8
SoA heuristic,40,30,0.019230769230769232,3.160000778734684e-05,10,21
MMG,40,30,0.019230769230769232,0.00021629990078508854,10,21
SoA heuristic,100,75,0.007575757575757576,6.010010838508606e-05,25,55
MMG,100,75,0.007575757575757576,0.0009006001055240631,25,55
SoA heuristic,200,150,0.0037688442211055275,0.00013180007226765156,50,91
MMG,200,150,0.0037688442211055275,0.003215000033378601,50,91
SoA heuristic,400,300,0.0018796992481203006,0.00020410004071891308,100,190
MMG,400,300,0.0018796992481203006,0.011593200033530593,100,190
SoA heuristic,600,450,0.0012520868113522537,0.00034609995782375336,150,286
MMG,600,450,0.0012520868113522537,0.028697599889710546,150,286
SoA heuristic,1000,750,0.0007507507507507507,0.0006839998532086611,250,494
MMG,1000,750,0.0007507507507507507,0.12190310005098581,250,494
SoA heuristic,2000,1500,0.00037518759379689845,0.001898700138553977,500,1072
MMG,2000,1500,0.00037518759379689845,0.4318769001401961,500,1072
SoA heuristic,4000,3000,0.00018754688672168043,0.00665550003759563,1000,1992
MMG,4000,3000,0.00018754688672168043,1.607077999971807,1000,1992
SoA heuristic,8000,6000,9.376172021502688e-05,0.009832399897277355,2000,4077
MMG,8000,6000,9.376172021502688e-05,6.810661400202662,2000,4077
SoA heuristic,20,15,0.039473684210526314,3.9300182834267616e-05,5,7
MMG,20,15,0.039473684210526314,0.00014290004037320614,5,7
SoA heuristic,40,30,0.019230769230769232,8.050003089010715e-05,10,18
MMG,40,30,0.019230769230769232,0.0005799001082777977,10,18
SoA heuristic,100,75,0.007575757575757576,0.00017179991118609905,25,55
MMG,100,75,0.007575757575757576,0.0025188999716192484,25,55
SoA heuristic,200,150,0.0037688442211055275,0.000108000123873353,50,99
MMG,200,150,0.0037688442211055275,0.0031208000145852566,50,99
SoA heuristic,400,300,0.0018796992481203006,0.00021350011229515076,100,202
MMG,400,300,0.0018796992481203006,0.011480200104415417,100,202
SoA heuristic,600,450,0.0012520868113522537,0.0005695000290870667,150,293
MMG,600,450,0.0012520868113522537,0.030542700085788965,150,293
SoA heuristic,1000,750,0.0007507507507507507,0.000879799947142601,250,494
MMG,1000,750,0.0007507507507507507,0.1166612000670284,250,494
SoA heuristic,2000,1500,0.00037518759379689845,0.0018700000364333391,500,975
MMG,2000,1500,0.00037518759379689845,0.46928120008669794,500,975
SoA heuristic,4000,3000,0.00018754688672168043,0.004141399869695306,1000,2038
MMG,4000,3000,0.00018754688672168043,1.8344972000923008,1000,2038
SoA heuristic,8000,6000,9.376172021502688e-05,0.011504900176078081,2000,4072
MMG,8000,6000,9.376172021502688e-05,7.405087299877778,2000,4072
SoA heuristic,20,15,0.039473684210526314,4.090019501745701e-05,5,7
MMG,20,15,0.039473684210526314,0.00012450013309717178,5,7
SoA heuristic,40,30,0.019230769230769232,4.409998655319214e-05,10,21
MMG,40,30,0.019230769230769232,0.00037599983625113964,10,21
SoA heuristic,100,75,0.007575757575757576,7.999991066753864e-05,25,47
MMG,100,75,0.007575757575757576,0.0011724999640136957,25,47
SoA heuristic,200,150,0.0037688442211055275,0.0001501999795436859,50,92
MMG,200,150,0.0037688442211055275,0.003979399800300598,50,92
SoA heuristic,400,300,0.0018796992481203006,0.00026260013692080975,100,212
MMG,400,300,0.0018796992481203006,0.014816500013694167,100,212
SoA heuristic,600,450,0.0012520868113522537,0.00041019986383616924,150,294
MMG,600,450,0.0012520868113522537,0.03186180000193417,150,294
SoA heuristic,1000,750,0.0007507507507507507,0.0008394999895244837,250,498
MMG,1000,750,0.0007507507507507507,0.08732279995456338,250,498
SoA heuristic,2000,1500,0.00037518759379689845,0.001705799950286746,500,962
MMG,2000,1500,0.00037518759379689845,0.3707106001675129,500,962
SoA heuristic,4000,3000,0.00018754688672168043,0.006773700006306171,1000,2023
MMG,4000,3000,0.00018754688672168043,1.41113690007478,1000,2023
SoA heuristic,8000,6000,9.376172021502688e-05,0.007108099991455674,2000,4009
MMG,8000,6000,9.376172021502688e-05,5.646592500153929,2000,4009
SoA heuristic,20,15,0.039473684210526314,3.6899931728839874e-05,5,13
MMG,20,15,0.039473684210526314,0.00013669999316334724,5,13
SoA heuristic,40,30,0.019230769230769232,4.319986328482628e-05,10,21
MMG,40,30,0.019230769230769232,0.0002911000046879053,10,21
SoA heuristic,100,75,0.007575757575757576,7.930002175271511e-05,25,37
MMG,100,75,0.007575757575757576,0.001197099918499589,25,37
SoA heuristic,200,150,0.0037688442211055275,0.00013599987141788006,50,94
MMG,200,150,0.0037688442211055275,0.0038840000052005053,50,94
SoA heuristic,400,300,0.0018796992481203006,0.00025809998624026775,100,204
MMG,400,300,0.0018796992481203006,0.014840899966657162,100,204
SoA heuristic,600,450,0.0012520868113522537,0.00040069990791380405,150,294
MMG,600,450,0.0012520868113522537,0.03284499980509281,150,294
SoA heuristic,1000,750,0.0007507507507507507,0.0006989000830799341,250,500
MMG,1000,750,0.0007507507507507507,0.08461340004578233,250,500
SoA heuristic,2000,1500,0.00037518759379689845,0.0013812000397592783,500,1015
MMG,2000,1500,0.00037518759379689845,0.3386695000808686,500,1015
SoA heuristic,4000,3000,0.00018754688672168043,0.0027373998891562223,1000,2023
MMG,4000,3000,0.00018754688672168043,1.399377399822697,1000,2023
SoA heuristic,8000,6000,9.376172021502688e-05,0.007061199983581901,2000,4151
MMG,8000,6000,9.376172021502688e-05,5.851722599938512,2000,4151
SoA heuristic,20,15,0.039473684210526314,3.109988756477833e-05,5,8
MMG,20,15,0.039473684210526314,9.599979966878891e-05,5,8
SoA heuristic,40,30,0.019230769230769232,3.4400029107928276e-05,10,20
MMG,40,30,0.019230769230769232,0.000215600011870265,10,20
SoA heuristic,100,75,0.007575757575757576,5.959998816251755e-05,25,47
MMG,100,75,0.007575757575757576,0.000893699936568737,25,47
SoA heuristic,200,150,0.0037688442211055275,0.00010530021972954273,50,97
MMG,200,150,0.0037688442211055275,0.003037199843674898,50,97
SoA heuristic,400,300,0.0018796992481203006,0.00020499993115663528,100,204
MMG,400,300,0.0018796992481203006,0.011232400080189109,100,204
SoA heuristic,600,450,0.0012520868113522537,0.00030280021019279957,150,289
MMG,600,450,0.0012520868113522537,0.025732100009918213,150,289
SoA heuristic,1000,750,0.0007507507507507507,0.000583800021559,250,512
MMG,1000,750,0.0007507507507507507,0.07140520005486906,250,512
SoA heuristic,2000,1500,0.00037518759379689845,0.0011810001451522112,500,929
MMG,2000,1500,0.00037518759379689845,0.28956019994802773,500,929
SoA heuristic,4000,3000,0.00018754688672168043,0.0029126000590622425,1000,2016
MMG,4000,3000,0.00018754688672168043,1.1712589000817388,1000,2016
SoA heuristic,8000,6000,9.376172021502688e-05,0.005932800006121397,2000,3978
MMG,8000,6000,9.376172021502688e-05,4.73253979999572,2000,3978
SoA heuristic,20,15,0.039473684210526314,3.1800009310245514e-05,5,12
MMG,20,15,0.039473684210526314,0.00010700011625885963,5,12
SoA heuristic,40,30,0.019230769230769232,3.620004281401634e-05,10,13
MMG,40,30,0.019230769230769232,0.00023330003023147583,10,13
SoA heuristic,100,75,0.007575757575757576,6.420002318918705e-05,25,52
MMG,100,75,0.007575757575757576,0.0009310999885201454,25,52
SoA heuristic,200,150,0.0037688442211055275,0.00010890001431107521,50,93
MMG,200,150,0.0037688442211055275,0.0030199000611901283,50,93
SoA heuristic,400,300,0.0018796992481203006,0.00020079989917576313,100,205
MMG,400,300,0.0018796992481203006,0.011775700142607093,100,205
SoA heuristic,600,450,0.0012520868113522537,0.00031839986331760883,150,270
MMG,600,450,0.0012520868113522537,0.027301100082695484,150,270
SoA heuristic,1000,750,0.0007507507507507507,0.0006185001693665981,250,523
MMG,1000,750,0.0007507507507507507,0.07363060000352561,250,523
SoA heuristic,2000,1500,0.00037518759379689845,0.0011964000295847654,500,1012
MMG,2000,1500,0.00037518759379689845,0.29603579989634454,500,1012
SoA heuristic,4000,3000,0.00018754688672168043,0.002412899862974882,1000,2040
MMG,4000,3000,0.00018754688672168043,1.1845277999527752,1000,2040
SoA heuristic,8000,6000,9.376172021502688e-05,0.005014300113543868,2000,3908
MMG,8000,6000,9.376172021502688e-05,4.771648800000548,2000,3908
SoA heuristic,20,15,0.039473684210526314,2.7600210160017014e-05,5,6
MMG,20,15,0.039473684210526314,9.649991989135742e-05,5,6
SoA heuristic,40,30,0.019230769230769232,4.020007327198982e-05,10,23
MMG,40,30,0.019230769230769232,0.00028089992702007294,10,23
SoA heuristic,100,75,0.007575757575757576,6.440002471208572e-05,25,40
MMG,100,75,0.007575757575757576,0.00098209991119802,25,40
SoA heuristic,200,150,0.0037688442211055275,0.00010360009036958218,50,108
MMG,200,150,0.0037688442211055275,0.00299579999409616,50,108
SoA heuristic,400,300,0.0018796992481203006,0.00027650012634694576,100,196
MMG,400,300,0.0018796992481203006,0.02372700022533536,100,196
SoA heuristic,600,450,0.0012520868113522537,0.000287200091406703,150,289
MMG,600,450,0.0012520868113522537,0.03290749993175268,150,289
SoA heuristic,1000,750,0.0007507507507507507,0.0019427998922765255,250,499
MMG,1000,750,0.0007507507507507507,0.09321690001524985,250,499
SoA heuristic,2000,1500,0.00037518759379689845,0.0012945998460054398,500,989
MMG,2000,1500,0.00037518759379689845,0.379321499960497,500,989
SoA heuristic,4000,3000,0.00018754688672168043,0.0024933000095188618,1000,2006
MMG,4000,3000,0.00018754688672168043,1.6121855999808758,1000,2006
SoA heuristic,8000,6000,9.376172021502688e-05,0.006772800115868449,2000,3955
MMG,8000,6000,9.376172021502688e-05,6.694176600081846,2000,3955
SoA heuristic,20,15,0.039473684210526314,5.4099829867482185e-05,5,11
MMG,20,15,0.039473684210526314,0.0002101000864058733,5,11
SoA heuristic,40,30,0.019230769230769232,7.640011608600616e-05,10,25
MMG,40,30,0.019230769230769232,0.0002992998342961073,10,25
SoA heuristic,100,75,0.007575757575757576,0.00014430005103349686,25,41
MMG,100,75,0.007575757575757576,0.0011783000081777573,25,41
SoA heuristic,200,150,0.0037688442211055275,0.0002126998733729124,50,87
MMG,200,150,0.0037688442211055275,0.006361400010064244,50,87
SoA heuristic,400,300,0.0018796992481203006,0.0004555999767035246,100,175
MMG,400,300,0.0018796992481203006,0.021228100173175335,100,175
SoA heuristic,600,450,0.0012520868113522537,0.00040989997796714306,150,301
MMG,600,450,0.0012520868113522537,0.04143640003167093,150,301
SoA heuristic,1000,750,0.0007507507507507507,0.0010671999771147966,250,527
MMG,1000,750,0.0007507507507507507,0.10006209998391569,250,527
SoA heuristic,2000,1500,0.00037518759379689845,0.0013819001615047455,500,1010
MMG,2000,1500,0.00037518759379689845,0.342600499978289,500,1010
SoA heuristic,4000,3000,0.00018754688672168043,0.0022574998438358307,1000,2011
MMG,4000,3000,0.00018754688672168043,1.8042478000279516,1000,2011
SoA heuristic,8000,6000,9.376172021502688e-05,0.03377950005233288,2000,3941
MMG,8000,6000,9.376172021502688e-05,6.444308799924329,2000,3941
SoA heuristic,20,15,0.039473684210526314,3.9400067180395126e-05,5,7
MMG,20,15,0.039473684210526314,0.00013269996270537376,5,7
SoA heuristic,40,30,0.019230769230769232,8.939998224377632e-05,10,14
MMG,40,30,0.019230769230769232,0.0006748000159859657,10,14
SoA heuristic,100,75,0.007575757575757576,0.00017360015772283077,25,43
MMG,100,75,0.007575757575757576,0.0027510998770594597,25,43
SoA heuristic,200,150,0.0037688442211055275,0.00030419998802244663,50,118
MMG,200,150,0.0037688442211055275,0.008415399817749858,50,118
SoA heuristic,400,300,0.0018796992481203006,0.0006102998740971088,100,178
MMG,400,300,0.0018796992481203006,0.032312500057742,100,178
SoA heuristic,600,450,0.0012520868113522537,0.00048450008034706116,150,277
MMG,600,450,0.0012520868113522537,0.049886299995705485,150,277
SoA heuristic,1000,750,0.0007507507507507507,0.0005238999146968126,250,524
MMG,1000,750,0.0007507507507507507,0.12334110005758703,250,524
SoA heuristic,2000,1500,0.00037518759379689845,0.0010621000546962023,500,1032
MMG,2000,1500,0.00037518759379689845,0.3298646998591721,500,1032
SoA heuristic,4000,3000,0.00018754688672168043,0.002500699833035469,1000,1942
MMG,4000,3000,0.00018754688672168043,1.5295663001015782,1000,1942
SoA heuristic,8000,6000,9.376172021502688e-05,0.005990699864923954,2000,4035
MMG,8000,6000,9.376172021502688e-05,6.868759199976921,2000,4035
SoA heuristic,20,15,0.039473684210526314,5.9900106862187386e-05,5,7
MMG,20,15,0.039473684210526314,0.0002492000348865986,5,7
SoA heuristic,40,30,0.019230769230769232,8.810008876025677e-05,10,19
MMG,40,30,0.019230769230769232,0.0008314999286085367,10,19
SoA heuristic,100,75,0.007575757575757576,0.00017450004816055298,25,36
MMG,100,75,0.007575757575757576,0.0025633000768721104,25,36
SoA heuristic,200,150,0.0037688442211055275,0.00031969998963177204,50,116
MMG,200,150,0.0037688442211055275,0.008423699997365475,50,116
SoA heuristic,400,300,0.0018796992481203006,0.00026950007304549217,100,208
MMG,400,300,0.0018796992481203006,0.012045199982821941,100,208
SoA heuristic,600,450,0.0012520868113522537,0.0008779000490903854,150,290
MMG,600,450,0.0012520868113522537,0.05080879991874099,150,290
SoA heuristic,1000,750,0.0007507507507507507,0.0016330000944435596,250,488
MMG,1000,750,0.0007507507507507507,0.10608389996923506,250,488
SoA heuristic,2000,1500,0.00037518759379689845,0.0029488999862223864,500,967
MMG,2000,1500,0.00037518759379689845,0.47021820000372827,500,967
SoA heuristic,4000,3000,0.00018754688672168043,0.0028621999081224203,1000,2003
MMG,4000,3000,0.00018754688672168043,1.8272469001822174,1000,2003
SoA heuristic,8000,6000,9.376172021502688e-05,0.03650819999165833,2000,4016
MMG,8000,6000,9.376172021502688e-05,7.221657000016421,2000,4016
SoA heuristic,20,15,0.039473684210526314,3.320001997053623e-05,5,11
MMG,20,15,0.039473684210526314,0.00027590012177824974,5,11
SoA heuristic,40,30,0.019230769230769232,8.340016938745975e-05,10,24
MMG,40,30,0.019230769230769232,0.0006957000587135553,10,24
SoA heuristic,100,75,0.007575757575757576,0.00016309996135532856,25,53
MMG,100,75,0.007575757575757576,0.0029044998809695244,25,53
SoA heuristic,200,150,0.0037688442211055275,0.00031869998201727867,50,94
MMG,200,150,0.0037688442211055275,0.007311500143259764,50,94
SoA heuristic,400,300,0.0018796992481203006,0.0004275999963283539,100,229
MMG,400,300,0.0018796992481203006,0.025281199952587485,100,229
SoA heuristic,600,450,0.0012520868113522537,0.0008747000247240067,150,256
MMG,600,450,0.0012520868113522537,0.02922919997945428,150,256
SoA heuristic,1000,750,0.0007507507507507507,0.001383200054988265,250,492
MMG,1000,750,0.0007507507507507507,0.08670599991455674,250,492
SoA heuristic,2000,1500,0.00037518759379689845,0.0036292998120188713,500,986
MMG,2000,1500,0.00037518759379689845,0.4987296999897808,500,986
SoA heuristic,4000,3000,0.00018754688672168043,0.0049703000113368034,1000,1942
MMG,4000,3000,0.00018754688672168043,1.9130348002072424,1000,1942
SoA heuristic,8000,6000,9.376172021502688e-05,0.06335850013419986,2000,4086
MMG,8000,6000,9.376172021502688e-05,6.570396699942648,2000,4086
SoA heuristic,20,15,0.039473684210526314,2.7200207114219666e-05,5,5
MMG,20,15,0.039473684210526314,9.570014663040638e-05,5,5
SoA heuristic,40,30,0.019230769230769232,8.25000461190939e-05,10,27
MMG,40,30,0.019230769230769232,0.0002484000287950039,10,27
SoA heuristic,100,75,0.007575757575757576,0.0001129999291151762,25,49
MMG,100,75,0.007575757575757576,0.0014835000038146973,25,49
SoA heuristic,200,150,0.0037688442211055275,0.00013349996879696846,50,80
MMG,200,150,0.0037688442211055275,0.006295300088822842,50,80
SoA heuristic,400,300,0.0018796992481203006,0.0001984999980777502,100,193
MMG,400,300,0.0018796992481203006,0.014806800056248903,100,193
SoA heuristic,600,450,0.0012520868113522537,0.0008187999483197927,150,296
MMG,600,450,0.0012520868113522537,0.042485499987378716,150,296
SoA heuristic,1000,750,0.0007507507507507507,0.0008390001021325588,250,495
MMG,1000,750,0.0007507507507507507,0.10227640019729733,250,495
SoA heuristic,2000,1500,0.00037518759379689845,0.0029248998034745455,500,1011
MMG,2000,1500,0.00037518759379689845,0.5330211000982672,500,1011
SoA heuristic,4000,3000,0.00018754688672168043,0.004038299899548292,1000,1956
MMG,4000,3000,0.00018754688672168043,2.0322732999920845,1000,1956
SoA heuristic,8000,6000,9.376172021502688e-05,0.004585500108078122,2000,3980
MMG,8000,6000,9.376172021502688e-05,7.584186299936846,2000,3980
SoA heuristic,20,15,0.039473684210526314,6.480002775788307e-05,5,11
MMG,20,15,0.039473684210526314,0.00027840002439916134,5,11
SoA heuristic,40,30,0.019230769230769232,4.83999028801918e-05,10,19
MMG,40,30,0.019230769230769232,0.0003437998238950968,10,19
SoA heuristic,100,75,0.007575757575757576,8.839997462928295e-05,25,47
MMG,100,75,0.007575757575757576,0.001464699860662222,25,47
SoA heuristic,200,150,0.0037688442211055275,0.00022980011999607086,50,114
MMG,200,150,0.0037688442211055275,0.005221500061452389,50,114
SoA heuristic,400,300,0.0018796992481203006,0.00019400008022785187,100,185
MMG,400,300,0.0018796992481203006,0.013691900065168738,100,185
SoA heuristic,600,450,0.0012520868113522537,0.0008054999634623528,150,300
MMG,600,450,0.0012520868113522537,0.06652570003643632,150,300
SoA heuristic,1000,750,0.0007507507507507507,0.0012740998063236475,250,492
MMG,1000,750,0.0007507507507507507,0.1376968000549823,250,492
SoA heuristic,2000,1500,0.00037518759379689845,0.001585699850693345,500,1065
MMG,2000,1500,0.00037518759379689845,0.506911400007084,500,1065
SoA heuristic,4000,3000,0.00018754688672168043,0.007544700056314468,1000,2004
MMG,4000,3000,0.00018754688672168043,1.9025310999713838,1000,2004
SoA heuristic,8000,6000,9.376172021502688e-05,0.005978399887681007,2000,4023
MMG,8000,6000,9.376172021502688e-05,7.603127600159496,2000,4023
SoA heuristic,20,15,0.039473684210526314,7.939990609884262e-05,5,13
MMG,20,15,0.039473684210526314,0.0003364000003784895,5,13
SoA heuristic,40,30,0.019230769230769232,9.849993512034416e-05,10,20
MMG,40,30,0.019230769230769232,0.0007076000329107046,10,20
SoA heuristic,100,75,0.007575757575757576,0.00018109986558556557,25,58
MMG,100,75,0.007575757575757576,0.002515900181606412,25,58
SoA heuristic,200,150,0.0037688442211055275,0.0003237000200897455,50,97
MMG,200,150,0.0037688442211055275,0.009566099848598242,50,97
SoA heuristic,400,300,0.0018796992481203006,0.0005922999698668718,100,199
MMG,400,300,0.0018796992481203006,0.03641519998200238,100,199
SoA heuristic,600,450,0.0012520868113522537,0.0005109000485390425,150,300
MMG,600,450,0.0012520868113522537,0.036696699913591146,150,300
SoA heuristic,1000,750,0.0007507507507507507,0.0005304000806063414,250,529
MMG,1000,750,0.0007507507507507507,0.11579149984754622,250,529
SoA heuristic,2000,1500,0.00037518759379689845,0.0017001000232994556,500,994
MMG,2000,1500,0.00037518759379689845,0.43744300003163517,500,994
SoA heuristic,4000,3000,0.00018754688672168043,0.002855099970474839,1000,2002
MMG,4000,3000,0.00018754688672168043,1.6659822999499738,1000,2002
SoA heuristic,8000,6000,9.376172021502688e-05,0.013641400029882789,2000,3920
MMG,8000,6000,9.376172021502688e-05,6.5047518000938,2000,3920
SoA heuristic,20,15,0.039473684210526314,7.090019062161446e-05,5,17
MMG,20,15,0.039473684210526314,0.0003130000550299883,5,17
SoA heuristic,40,30,0.019230769230769232,9.440002031624317e-05,10,26
MMG,40,30,0.019230769230769232,0.0006506999488919973,10,26
SoA heuristic,100,75,0.007575757575757576,0.0002475001383572817,25,66
MMG,100,75,0.007575757575757576,0.002780799986794591,25,66
SoA heuristic,200,150,0.0037688442211055275,0.00027680001221597195,50,110
MMG,200,150,0.0037688442211055275,0.009298499906435609,50,110
SoA heuristic,400,300,0.0018796992481203006,0.000591200077906251,100,192
MMG,400,300,0.0018796992481203006,0.0327763999812305,100,192
SoA heuristic,600,450,0.0012520868113522537,0.001517399912700057,150,307
MMG,600,450,0.0012520868113522537,0.03383140009827912,150,307
SoA heuristic,1000,750,0.0007507507507507507,0.000542100053280592,250,488
MMG,1000,750,0.0007507507507507507,0.11376319988630712,250,488
SoA heuristic,2000,1500,0.00037518759379689845,0.0010951999574899673,500,1067
MMG,2000,1500,0.00037518759379689845,0.544165600091219,500,1067
SoA heuristic,4000,3000,0.00018754688672168043,0.0027314999606460333,1000,1984
MMG,4000,3000,0.00018754688672168043,2.043491199845448,1000,1984
SoA heuristic,8000,6000,9.376172021502688e-05,0.0500080999918282,2000,3946
MMG,8000,6000,9.376172021502688e-05,7.635169600136578,2000,3946
SoA heuristic,20,15,0.039473684210526314,7.509998977184296e-05,5,8
MMG,20,15,0.039473684210526314,0.00029230001382529736,5,8
SoA heuristic,40,30,0.019230769230769232,3.320001997053623e-05,10,19
MMG,40,30,0.019230769230769232,0.0002188999205827713,10,19
SoA heuristic,100,75,0.007575757575757576,5.819997750222683e-05,25,50
MMG,100,75,0.007575757575757576,0.0008819000795483589,25,50
SoA heuristic,200,150,0.0037688442211055275,0.00010539987124502659,50,92
MMG,200,150,0.0037688442211055275,0.0040882001630961895,50,92
SoA heuristic,400,300,0.0018796992481203006,0.0006431997753679752,100,213
MMG,400,300,0.0018796992481203006,0.03328579990193248,100,213
SoA heuristic,600,450,0.0012520868113522537,0.0009089000523090363,150,280
MMG,600,450,0.0012520868113522537,0.04851679992862046,150,280
SoA heuristic,1000,750,0.0007507507507507507,0.0008914000354707241,250,502
MMG,1000,750,0.0007507507507507507,0.13876550015993416,250,502
SoA heuristic,2000,1500,0.00037518759379689845,0.001509800087660551,500,967
MMG,2000,1500,0.00037518759379689845,0.3780479999259114,500,967
SoA heuristic,4000,3000,0.00018754688672168043,0.002431199885904789,1000,2048
MMG,4000,3000,0.00018754688672168043,1.6928039998747408,1000,2048
SoA heuristic,8000,6000,9.376172021502688e-05,0.005780099891126156,2000,3942
MMG,8000,6000,9.376172021502688e-05,6.6013251999393106,2000,3942
SoA heuristic,20,15,0.039473684210526314,9.519979357719421e-05,5,12
MMG,20,15,0.039473684210526314,0.00038350000977516174,5,12
SoA heuristic,40,30,0.019230769230769232,0.00011059991084039211,10,18
MMG,40,30,0.019230769230769232,0.0007112999446690083,10,18
SoA heuristic,100,75,0.007575757575757576,0.0001987998839467764,25,50
MMG,100,75,0.007575757575757576,0.0012637998443096876,25,50
SoA heuristic,200,150,0.0037688442211055275,0.00010300008580088615,50,89
MMG,200,150,0.0037688442211055275,0.008967199828475714,50,89
SoA heuristic,400,300,0.0018796992481203006,0.0006289000157266855,100,189
MMG,400,300,0.0018796992481203006,0.014720099978148937,100,189
SoA heuristic,600,450,0.0012520868113522537,0.00028110016137361526,150,318
MMG,600,450,0.0012520868113522537,0.06812770012766123,150,318
SoA heuristic,1000,750,0.0007507507507507507,0.0006583998911082745,250,445
MMG,1000,750,0.0007507507507507507,0.11074689985252917,250,445
SoA heuristic,2000,1500,0.00037518759379689845,0.003942399984225631,500,1030
MMG,2000,1500,0.00037518759379689845,0.4379416999872774,500,1030
SoA heuristic,4000,3000,0.00018754688672168043,0.003827099921181798,1000,1998
MMG,4000,3000,0.00018754688672168043,1.887641099980101,1000,1998
SoA heuristic,8000,6000,9.376172021502688e-05,0.059048299910500646,2000,4161
MMG,8000,6000,9.376172021502688e-05,7.13828740012832,2000,4161
SoA heuristic,20,15,0.039473684210526314,3.0099879950284958e-05,5,9
MMG,20,15,0.039473684210526314,9.590014815330505e-05,5,9
SoA heuristic,40,30,0.019230769230769232,3.2499898225069046e-05,10,26
MMG,40,30,0.019230769230769232,0.0003043001051992178,10,26
SoA heuristic,100,75,0.007575757575757576,0.00010029994882643223,25,69
MMG,100,75,0.007575757575757576,0.001550799934193492,25,69
SoA heuristic,200,150,0.0037688442211055275,0.0003746999427676201,50,110
MMG,200,150,0.0037688442211055275,0.008851799881085753,50,110
SoA heuristic,400,300,0.0018796992481203006,0.0006544999778270721,100,192
MMG,400,300,0.0018796992481203006,0.02742610010318458,100,192
SoA heuristic,600,450,0.0012520868113522537,0.0008568000048398972,150,329
MMG,600,450,0.0012520868113522537,0.04273850005120039,150,329
SoA heuristic,1000,750,0.0007507507507507507,0.0007728999480605125,250,481
MMG,1000,750,0.0007507507507507507,0.08610020019114017,250,481
SoA heuristic,2000,1500,0.00037518759379689845,0.0013148998841643333,500,980
MMG,2000,1500,0.00037518759379689845,0.3962829001247883,500,980
SoA heuristic,4000,3000,0.00018754688672168043,0.004753899993374944,1000,1950
MMG,4000,3000,0.00018754688672168043,1.7516942999791354,1000,1950
SoA heuristic,8000,6000,9.376172021502688e-05,0.06015040003694594,2000,3936
MMG,8000,6000,9.376172021502688e-05,7.361254499992356,2000,3936
SoA heuristic,20,15,0.039473684210526314,7.229996845126152e-05,5,8
MMG,20,15,0.039473684210526314,0.00010149995796382427,5,8
SoA heuristic,40,30,0.019230769230769232,3.760005347430706e-05,10,29
MMG,40,30,0.019230769230769232,0.0002413000911474228,10,29
SoA heuristic,100,75,0.007575757575757576,6.710016168653965e-05,25,42
MMG,100,75,0.007575757575757576,0.001667100004851818,25,42
SoA heuristic,200,150,0.0037688442211055275,0.0001243001315742731,50,76
MMG,200,150,0.0037688442211055275,0.0033973001409322023,50,76
SoA heuristic,400,300,0.0018796992481203006,0.00020949984900653362,100,197
MMG,400,300,0.0018796992481203006,0.014527300139889121,100,197
SoA heuristic,600,450,0.0012520868113522537,0.00038299988955259323,150,297
MMG,600,450,0.0012520868113522537,0.026822000043466687,150,297
SoA heuristic,1000,750,0.0007507507507507507,0.000689599895849824,250,491
MMG,1000,750,0.0007507507507507507,0.09354440006427467,250,491
SoA heuristic,2000,1500,0.00037518759379689845,0.0017486000433564186,500,1003
MMG,2000,1500,0.00037518759379689845,0.4150165000464767,500,1003
SoA heuristic,4000,3000,0.00018754688672168043,0.0040188999846577644,1000,2032
MMG,4000,3000,0.00018754688672168043,1.7600420000962913,1000,2032
SoA heuristic,8000,6000,9.376172021502688e-05,0.04035790008492768,2000,4023
MMG,8000,6000,9.376172021502688e-05,7.22705790004693,2000,4023
SoA heuristic,20,15,0.039473684210526314,3.220001235604286e-05,5,14
MMG,20,15,0.039473684210526314,9.970017708837986e-05,5,14
SoA heuristic,40,30,0.019230769230769232,3.120000474154949e-05,10,24
MMG,40,30,0.019230769230769232,0.00021080020815134048,10,24
SoA heuristic,100,75,0.007575757575757576,5.62998466193676e-05,25,47
MMG,100,75,0.007575757575757576,0.0009696998167783022,25,47
SoA heuristic,200,150,0.0037688442211055275,0.00010609999299049377,50,113
MMG,200,150,0.0037688442211055275,0.003244399791583419,50,113
SoA heuristic,400,300,0.0018796992481203006,0.00022240006364881992,100,179
MMG,400,300,0.0018796992481203006,0.012553900014609098,100,179
SoA heuristic,600,450,0.0012520868113522537,0.0002935999073088169,150,294
MMG,600,450,0.0012520868113522537,0.025894999969750643,150,294
SoA heuristic,1000,750,0.0007507507507507507,0.0005544000305235386,250,489
MMG,1000,750,0.0007507507507507507,0.10516440006904304,250,489
SoA heuristic,2000,1500,0.00037518759379689845,0.001349500147625804,500,976
MMG,2000,1500,0.00037518759379689845,0.49741740012541413,500,976
SoA heuristic,4000,3000,0.00018754688672168043,0.007233599899336696,1000,2048
MMG,4000,3000,0.00018754688672168043,1.6375090000219643,1000,2048
SoA heuristic,8000,6000,9.376172021502688e-05,0.005839999997988343,2000,3918
MMG,8000,6000,9.376172021502688e-05,7.126034699846059,2000,3918
SoA heuristic,20,15,0.039473684210526314,6.800005212426186e-05,5,10
MMG,20,15,0.039473684210526314,0.00028939987532794476,5,10
SoA heuristic,40,30,0.019230769230769232,3.6300159990787506e-05,10,21
MMG,40,30,0.019230769230769232,0.00024419999681413174,10,21
SoA heuristic,100,75,0.007575757575757576,6.500002928078175e-05,25,49
MMG,100,75,0.007575757575757576,0.0012562999036163092,25,49
SoA heuristic,200,150,0.0037688442211055275,0.0003128999378532171,50,106
MMG,200,150,0.0037688442211055275,0.008039700100198388,50,106
SoA heuristic,400,300,0.0018796992481203006,0.00026369979605078697,100,207
MMG,400,300,0.0018796992481203006,0.011260600062087178,100,207
SoA heuristic,600,450,0.0012520868113522537,0.0002812999300658703,150,281
MMG,600,450,0.0012520868113522537,0.04590500006452203,150,281
SoA heuristic,1000,750,0.0007507507507507507,0.0011748000979423523,250,482
MMG,1000,750,0.0007507507507507507,0.08733190014027059,250,482
SoA heuristic,2000,1500,0.00037518759379689845,0.0017801998183131218,500,1000
MMG,2000,1500,0.00037518759379689845,0.4629164000507444,500,1000
SoA heuristic,4000,3000,0.00018754688672168043,0.0033252001740038395,1000,1951
MMG,4000,3000,0.00018754688672168043,1.864866300020367,1000,1951
SoA heuristic,8000,6000,9.376172021502688e-05,0.005215800134465098,2000,3999
MMG,8000,6000,9.376172021502688e-05,7.513580000028014,2000,3999
SoA heuristic,20,15,0.039473684210526314,6.320001557469368e-05,5,7
MMG,20,15,0.039473684210526314,0.0002429999876767397,5,7
SoA heuristic,40,30,0.019230769230769232,3.290013410151005e-05,10,18
MMG,40,30,0.019230769230769232,0.0002272001001983881,10,18
SoA heuristic,100,75,0.007575757575757576,6.029987707734108e-05,25,64
MMG,100,75,0.007575757575757576,0.0015436999965459108,25,64
SoA heuristic,200,150,0.0037688442211055275,0.00010329997166991234,50,109
MMG,200,150,0.0037688442211055275,0.007138899993151426,50,109
SoA heuristic,400,300,0.0018796992481203006,0.0002874999772757292,100,196
MMG,400,300,0.0018796992481203006,0.026918899966403842,100,196
SoA heuristic,600,450,0.0012520868113522537,0.0007270998321473598,150,319
MMG,600,450,0.0012520868113522537,0.03391840006224811,150,319
SoA heuristic,1000,750,0.0007507507507507507,0.0015490001533180475,250,487
MMG,1000,750,0.0007507507507507507,0.13807639991864562,250,487
SoA heuristic,2000,1500,0.00037518759379689845,0.0038419000338763,500,1024
MMG,2000,1500,0.00037518759379689845,0.44172520004212856,500,1024
SoA heuristic,4000,3000,0.00018754688672168043,0.0035674001555889845,1000,1998
MMG,4000,3000,0.00018754688672168043,2.0461021999362856,1000,1998
SoA heuristic,8000,6000,9.376172021502688e-05,0.004394899820908904,2000,3951
MMG,8000,6000,9.376172021502688e-05,7.598379199858755,2000,3951
SoA heuristic,20,15,0.039473684210526314,2.7999980375170708e-05,5,16
MMG,20,15,0.039473684210526314,8.970010094344616e-05,5,16
SoA heuristic,40,30,0.019230769230769232,3.1300121918320656e-05,10,20
MMG,40,30,0.019230769230769232,0.00023230002261698246,10,20
SoA heuristic,100,75,0.007575757575757576,5.8300094678997993e-05,25,55
MMG,100,75,0.007575757575757576,0.0008914999198168516,25,55
SoA heuristic,200,150,0.0037688442211055275,0.00010440009646117687,50,113
MMG,200,150,0.0037688442211055275,0.003158499952405691,50,113
SoA heuristic,400,300,0.0018796992481203006,0.0003307000733911991,100,200
MMG,400,300,0.0018796992481203006,0.01753770001232624,100,200
SoA heuristic,600,450,0.0012520868113522537,0.00041390000842511654,150,264
MMG,600,450,0.0012520868113522537,0.05954089993610978,150,264
SoA heuristic,1000,750,0.0007507507507507507,0.001180300023406744,250,479
MMG,1000,750,0.0007507507507507507,0.103247000137344,250,479
SoA heuristic,2000,1500,0.00037518759379689845,0.0010603000409901142,500,957
MMG,2000,1500,0.00037518759379689845,0.5126204001717269,500,957
SoA heuristic,4000,3000,0.00018754688672168043,0.0021666998509317636,1000,1985
MMG,4000,3000,0.00018754688672168043,1.9267818999942392,1000,1985
SoA heuristic,8000,6000,9.376172021502688e-05,0.008642199914902449,2000,4015
MMG,8000,6000,9.376172021502688e-05,7.663285700138658,2000,4015
SoA heuristic,20,15,0.039473684210526314,7.469998672604561e-05,5,8
MMG,20,15,0.039473684210526314,0.00025599985383450985,5,8
SoA heuristic,40,30,0.019230769230769232,9.370013140141964e-05,10,26
MMG,40,30,0.019230769230769232,0.0002093000803142786,10,26
SoA heuristic,100,75,0.007575757575757576,0.0001697998959571123,25,46
MMG,100,75,0.007575757575757576,0.0029855000320822,25,46
SoA heuristic,200,150,0.0037688442211055275,0.0003082000184804201,50,116
MMG,200,150,0.0037688442211055275,0.0035582000855356455,50,116
SoA heuristic,400,300,0.0018796992481203006,0.0005506998859345913,100,206
MMG,400,300,0.0018796992481203006,0.019066800130531192,100,206
SoA heuristic,600,450,0.0012520868113522537,0.0008626999333500862,150,297
MMG,600,450,0.0012520868113522537,0.05896700010634959,150,297
SoA heuristic,1000,750,0.0007507507507507507,0.001444400055333972,250,520
MMG,1000,750,0.0007507507507507507,0.12442280002869666,250,520
SoA heuristic,2000,1500,0.00037518759379689845,0.0018241999205201864,500,934
MMG,2000,1500,0.00037518759379689845,0.4617119000758976,500,934
SoA heuristic,4000,3000,0.00018754688672168043,0.003624300006777048,1000,1957
MMG,4000,3000,0.00018754688672168043,1.9208941999822855,1000,1957
SoA heuristic,8000,6000,9.376172021502688e-05,0.014036400010809302,2000,4098
MMG,8000,6000,9.376172021502688e-05,7.639607399934903,2000,4098
SoA heuristic,20,15,0.039473684210526314,2.8499867767095566e-05,5,12
MMG,20,15,0.039473684210526314,9.58999153226614e-05,5,12
SoA heuristic,40,30,0.019230769230769232,3.120000474154949e-05,10,16
MMG,40,30,0.019230769230769232,0.00021690013818442822,10,16
SoA heuristic,100,75,0.007575757575757576,5.6999968364834785e-05,25,42
MMG,100,75,0.007575757575757576,0.0009045000188052654,25,42
SoA heuristic,200,150,0.0037688442211055275,0.00010409997776150703,50,96
MMG,200,150,0.0037688442211055275,0.0040799998678267,50,96
SoA heuristic,400,300,0.0018796992481203006,0.0005526000168174505,100,174
MMG,400,300,0.0018796992481203006,0.028064699843525887,100,174
SoA heuristic,600,450,0.0012520868113522537,0.0002796000335365534,150,299
MMG,600,450,0.0012520868113522537,0.02437529992312193,150,299
SoA heuristic,1000,750,0.0007507507507507507,0.0014227000065147877,250,511
MMG,1000,750,0.0007507507507507507,0.10363959986716509,250,511
SoA heuristic,2000,1500,0.00037518759379689845,0.00305830012075603,500,937
MMG,2000,1500,0.00037518759379689845,0.5371459999587387,500,937
SoA heuristic,4000,3000,0.00018754688672168043,0.0021121001336723566,1000,1937
MMG,4000,3000,0.00018754688672168043,1.8095875999424607,1000,1937
SoA heuristic,8000,6000,9.376172021502688e-05,0.006618000101298094,2000,4005
MMG,8000,6000,9.376172021502688e-05,7.68233980005607,2000,4005
SoA heuristic,20,15,0.039473684210526314,2.6999972760677338e-05,5,10
MMG,20,15,0.039473684210526314,9.039998985826969e-05,5,10
SoA heuristic,40,30,0.019230769230769232,3.1299889087677e-05,10,25
MMG,40,30,0.019230769230769232,0.00021279999054968357,10,25
SoA heuristic,100,75,0.007575757575757576,5.559995770454407e-05,25,55
MMG,100,75,0.007575757575757576,0.0011760999914258718,25,55
SoA heuristic,200,150,0.0037688442211055275,0.00022680009715259075,50,103
MMG,200,150,0.0037688442211055275,0.005032700020819902,50,103
SoA heuristic,400,300,0.0018796992481203006,0.0002313000150024891,100,188
MMG,400,300,0.0018796992481203006,0.022749199997633696,100,188
SoA heuristic,600,450,0.0012520868113522537,0.0002905000001192093,150,268
MMG,600,450,0.0012520868113522537,0.04333140002563596,150,268
SoA heuristic,1000,750,0.0007507507507507507,0.001350299920886755,250,510
MMG,1000,750,0.0007507507507507507,0.11297290003858507,250,510
SoA heuristic,2000,1500,0.00037518759379689845,0.003275100141763687,500,1025
MMG,2000,1500,0.00037518759379689845,0.49320749985054135,500,1025
SoA heuristic,4000,3000,0.00018754688672168043,0.004509800113737583,1000,2040
MMG,4000,3000,0.00018754688672168043,2.0078756001312286,1000,2040
SoA heuristic,8000,6000,9.376172021502688e-05,0.00786709995009005,2000,4033
MMG,8000,6000,9.376172021502688e-05,7.921190700028092,2000,4033
SoA heuristic,20,15,0.039473684210526314,6.13001175224781e-05,5,8
MMG,20,15,0.039473684210526314,0.0002921998966485262,5,8
SoA heuristic,40,30,0.019230769230769232,3.569992259144783e-05,10,19
MMG,40,30,0.019230769230769232,0.0002164999023079872,10,19
SoA heuristic,100,75,0.007575757575757576,5.7399971410632133e-05,25,49
MMG,100,75,0.007575757575757576,0.0026122000999748707,25,49
SoA heuristic,200,150,0.0037688442211055275,0.00030809990130364895,50,108
MMG,200,150,0.0037688442211055275,0.005416900152340531,50,108
SoA heuristic,400,300,0.0018796992481203006,0.0005816998891532421,100,221
MMG,400,300,0.0018796992481203006,0.017096499912440777,100,221
SoA heuristic,600,450,0.0012520868113522537,0.00039430009201169014,150,273
MMG,600,450,0.0012520868113522537,0.060456300154328346,150,273
SoA heuristic,1000,750,0.0007507507507507507,0.0006870999932289124,250,540
MMG,1000,750,0.0007507507507507507,0.1014915001578629,250,540
SoA heuristic,2000,1500,0.00037518759379689845,0.0040837000124156475,500,945
MMG,2000,1500,0.00037518759379689845,0.5028204000554979,500,945
SoA heuristic,4000,3000,0.00018754688672168043,0.002314699813723564,1000,2034
MMG,4000,3000,0.00018754688672168043,1.7359155998565257,1000,2034
SoA heuristic,8000,6000,9.376172021502688e-05,0.04391489992849529,2000,4114
MMG,8000,6000,9.376172021502688e-05,7.652169200126082,2000,4114
SoA heuristic,20,15,0.039473684210526314,6.0900114476680756e-05,5,9
MMG,20,15,0.039473684210526314,0.0001639002002775669,5,9
SoA heuristic,40,30,0.019230769230769232,5.179992876946926e-05,10,16
MMG,40,30,0.019230769230769232,0.0003758000675588846,10,16
SoA heuristic,100,75,0.007575757575757576,7.280008867383003e-05,25,50
MMG,100,75,0.007575757575757576,0.0011633001267910004,25,50
SoA heuristic,200,150,0.0037688442211055275,0.0001425000373274088,50,95
MMG,200,150,0.0037688442211055275,0.00301939994096756,50,95
SoA heuristic,400,300,0.0018796992481203006,0.00019159982912242413,100,195
MMG,400,300,0.0018796992481203006,0.011033499846234918,100,195
SoA heuristic,600,450,0.0012520868113522537,0.00028849998489022255,150,292
MMG,600,450,0.0012520868113522537,0.04222319996915758,150,292
SoA heuristic,1000,750,0.0007507507507507507,0.0016369998920708895,250,519
MMG,1000,750,0.0007507507507507507,0.12860909989103675,250,519
SoA heuristic,2000,1500,0.00037518759379689845,0.0013077000621706247,500,979
MMG,2000,1500,0.00037518759379689845,0.4743313998915255,500,979
SoA heuristic,4000,3000,0.00018754688672168043,0.002194999950006604,1000,1981
MMG,4000,3000,0.00018754688672168043,2.077886800048873,1000,1981
SoA heuristic,8000,6000,9.376172021502688e-05,0.006673300173133612,2000,4119
MMG,8000,6000,9.376172021502688e-05,7.26954730018042,2000,4119
SoA heuristic,20,15,0.039473684210526314,9.280000813305378e-05,5,15
MMG,20,15,0.039473684210526314,0.0002592001110315323,5,15
SoA heuristic,40,30,0.019230769230769232,9.280000813305378e-05,10,15
MMG,40,30,0.019230769230769232,0.0006621999200433493,10,15
SoA heuristic,100,75,0.007575757575757576,0.00013479986228048801,25,48
MMG,100,75,0.007575757575757576,0.001836499897763133,25,48
SoA heuristic,200,150,0.0037688442211055275,0.00013279984705150127,50,96
MMG,200,150,0.0037688442211055275,0.009098599897697568,50,96
SoA heuristic,400,300,0.0018796992481203006,0.00046060001477599144,100,197
MMG,400,300,0.0018796992481203006,0.023002400062978268,100,197
SoA heuristic,600,450,0.0012520868113522537,0.0008074999786913395,150,309
MMG,600,450,0.0012520868113522537,0.05369649990461767,150,309
SoA heuristic,1000,750,0.0007507507507507507,0.0015003001317381859,250,494
MMG,1000,750,0.0007507507507507507,0.14431230002082884,250,494
SoA heuristic,2000,1500,0.00037518759379689845,0.0010571000166237354,500,985
MMG,2000,1500,0.00037518759379689845,0.3924457998946309,500,985
SoA heuristic,4000,3000,0.00018754688672168043,0.003668299876153469,1000,2057
MMG,4000,3000,0.00018754688672168043,1.9489543999079615,1000,2057
SoA heuristic,8000,6000,9.376172021502688e-05,0.016714599914848804,2000,3983
MMG,8000,6000,9.376172021502688e-05,7.013260900042951,2000,3983
SoA heuristic,20,15,0.039473684210526314,2.750009298324585e-05,5,12
MMG,20,15,0.039473684210526314,9.240000508725643e-05,5,12
SoA heuristic,40,30,0.019230769230769232,3.1800009310245514e-05,10,20
MMG,40,30,0.019230769230769232,0.00021580001339316368,10,20
SoA heuristic,100,75,0.007575757575757576,5.850009620189667e-05,25,52
MMG,100,75,0.007575757575757576,0.0009228000417351723,25,52
SoA heuristic,200,150,0.0037688442211055275,0.000107599887996912,50,96
MMG,200,150,0.0037688442211055275,0.0031932999845594168,50,96
SoA heuristic,400,300,0.0018796992481203006,0.0005547998007386923,100,203
MMG,400,300,0.0018796992481203006,0.01310899993404746,100,203
SoA heuristic,600,450,0.0012520868113522537,0.0008171999361366034,150,286
MMG,600,450,0.0012520868113522537,0.03293760004453361,150,286
SoA heuristic,1000,750,0.0007507507507507507,0.0007209999021142721,250,504
MMG,1000,750,0.0007507507507507507,0.07187839993275702,250,504
SoA heuristic,2000,1500,0.00037518759379689845,0.0012841999996453524,500,1064
MMG,2000,1500,0.00037518759379689845,0.3784418001305312,500,1064
SoA heuristic,4000,3000,0.00018754688672168043,0.002228299854323268,1000,1946
MMG,4000,3000,0.00018754688672168043,1.582929000025615,1000,1946
SoA heuristic,8000,6000,9.376172021502688e-05,0.010089399991557002,2000,3859
MMG,8000,6000,9.376172021502688e-05,7.209254899993539,2000,3859
SoA heuristic,20,15,0.039473684210526314,2.869986928999424e-05,5,14
MMG,20,15,0.039473684210526314,9.229988791048527e-05,5,14
SoA heuristic,40,30,0.019230769230769232,8.130003698170185e-05,10,15
MMG,40,30,0.019230769230769232,0.0004743000026792288,10,15
SoA heuristic,100,75,0.007575757575757576,5.910010077059269e-05,25,46
MMG,100,75,0.007575757575757576,0.0014595999382436275,25,46
SoA heuristic,200,150,0.0037688442211055275,0.00014369981363415718,50,100
MMG,200,150,0.0037688442211055275,0.007701499853283167,50,100
SoA heuristic,400,300,0.0018796992481203006,0.0005584999453276396,100,178
MMG,400,300,0.0018796992481203006,0.022127500036731362,100,178
SoA heuristic,600,450,0.0012520868113522537,0.0003043999895453453,150,333
MMG,600,450,0.0012520868113522537,0.028322399826720357,150,333
SoA heuristic,1000,750,0.0007507507507507507,0.0005516000092029572,250,470
MMG,1000,750,0.0007507507507507507,0.12591090006753802,250,470
SoA heuristic,2000,1500,0.00037518759379689845,0.0020951000042259693,500,988
MMG,2000,1500,0.00037518759379689845,0.32641470013186336,500,988
SoA heuristic,4000,3000,0.00018754688672168043,0.04636049992404878,1000,2025
MMG,4000,3000,0.00018754688672168043,1.3681016999762505,1000,2025
SoA heuristic,8000,6000,9.376172021502688e-05,0.014710299903526902,2000,4003
MMG,8000,6000,9.376172021502688e-05,7.014789399923757,2000,4003
SoA heuristic,20,15,0.039473684210526314,7.440010085701942e-05,5,8
MMG,20,15,0.039473684210526314,0.0002976998221129179,5,8
SoA heuristic,40,30,0.019230769230769232,0.00011019990779459476,10,31
MMG,40,30,0.019230769230769232,0.0009518000297248363,10,31
SoA heuristic,100,75,0.007575757575757576,0.00019360007718205452,25,50
MMG,100,75,0.007575757575757576,0.002809799974784255,25,50
SoA heuristic,200,150,0.0037688442211055275,0.00034440006129443645,50,111
MMG,200,150,0.0037688442211055275,0.009366899961605668,50,111
SoA heuristic,400,300,0.0018796992481203006,0.0004985998384654522,100,176
MMG,400,300,0.0018796992481203006,0.025552100036293268,100,176
SoA heuristic,600,450,0.0012520868113522537,0.0008737000171095133,150,294
MMG,600,450,0.0012520868113522537,0.04291919991374016,150,294
SoA heuristic,1000,750,0.0007507507507507507,0.0016223997808992863,250,565
MMG,1000,750,0.0007507507507507507,0.1532582000363618,250,565
SoA heuristic,2000,1500,0.00037518759379689845,0.001813800074160099,500,977
MMG,2000,1500,0.00037518759379689845,0.4074411001056433,500,977
SoA heuristic,4000,3000,0.00018754688672168043,0.002401899779215455,1000,2033
MMG,4000,3000,0.00018754688672168043,1.940405499888584,1000,2033
SoA heuristic,8000,6000,9.376172021502688e-05,0.010350099997594953,2000,3986
MMG,8000,6000,9.376172021502688e-05,7.172714000102133,2000,3986
SoA heuristic,20,15,0.039473684210526314,2.8299866244196892e-05,5,8
MMG,20,15,0.039473684210526314,9.130011312663555e-05,5,8
SoA heuristic,40,30,0.019230769230769232,4.8900023102760315e-05,10,20
MMG,40,30,0.019230769230769232,0.00022469996474683285,10,20
SoA heuristic,100,75,0.007575757575757576,5.869986489415169e-05,25,37
MMG,100,75,0.007575757575757576,0.0008786001708358526,25,37
SoA heuristic,200,150,0.0037688442211055275,0.00010279985144734383,50,108
MMG,200,150,0.0037688442211055275,0.0029758999589830637,50,108
SoA heuristic,400,300,0.0018796992481203006,0.00019149994477629662,100,176
MMG,400,300,0.0018796992481203006,0.017725100042298436,100,176
SoA heuristic,600,450,0.0012520868113522537,0.0004813000559806824,150,304
MMG,600,450,0.0012520868113522537,0.02595050004310906,150,304
SoA heuristic,1000,750,0.0007507507507507507,0.0005389000289142132,250,497
MMG,1000,750,0.0007507507507507507,0.06965980003587902,250,497
SoA heuristic,2000,1500,0.00037518759379689845,0.0011141998693346977,500,1002
MMG,2000,1500,0.00037518759379689845,0.501965300180018,500,1002
SoA heuristic,4000,3000,0.00018754688672168043,0.0029052000027149916,1000,1937
MMG,4000,3000,0.00018754688672168043,1.7753536999225616,1000,1937
SoA heuristic,8000,6000,9.376172021502688e-05,0.04428969998843968,2000,4063
MMG,8000,6000,9.376172021502688e-05,7.377889900002629,2000,4063
SoA heuristic,20,15,0.039473684210526314,5.6099845096468925e-05,5,12
MMG,20,15,0.039473684210526314,0.00023010000586509705,5,12
SoA heuristic,40,30,0.019230769230769232,3.260001540184021e-05,10,22
MMG,40,30,0.019230769230769232,0.00021500000730156898,10,22
SoA heuristic,100,75,0.007575757575757576,6.16998877376318e-05,25,63
MMG,100,75,0.007575757575757576,0.0014104999136179686,25,63
SoA heuristic,200,150,0.0037688442211055275,0.00010740011930465698,50,107
MMG,200,150,0.0037688442211055275,0.005624900106340647,50,107
SoA heuristic,400,300,0.0018796992481203006,0.00019569997675716877,100,209
MMG,400,300,0.0018796992481203006,0.019386700121685863,100,209
SoA heuristic,600,450,0.0012520868113522537,0.0002828999422490597,150,313
MMG,600,450,0.0012520868113522537,0.0347959001082927,150,313
SoA heuristic,1000,750,0.0007507507507507507,0.0005239001475274563,250,495
MMG,1000,750,0.0007507507507507507,0.08493180014193058,250,495
SoA heuristic,2000,1500,0.00037518759379689845,0.0015209999401122332,500,1030
MMG,2000,1500,0.00037518759379689845,0.4279048000462353,500,1030
SoA heuristic,4000,3000,0.00018754688672168043,0.0021314998157322407,1000,2061
MMG,4000,3000,0.00018754688672168043,1.498522800160572,1000,2061
SoA heuristic,8000,6000,9.376172021502688e-05,0.006367499940097332,2000,3964
MMG,8000,6000,9.376172021502688e-05,6.392160299932584,2000,3964
SoA heuristic,20,15,0.039473684210526314,6.570015102624893e-05,5,11
MMG,20,15,0.039473684210526314,0.0002730002161115408,5,11
SoA heuristic,40,30,0.019230769230769232,8.490006439387798e-05,10,17
MMG,40,30,0.019230769230769232,0.0005149999633431435,10,17
SoA heuristic,100,75,0.007575757575757576,6.079999729990959e-05,25,42
MMG,100,75,0.007575757575757576,0.0008932000491768122,25,42
SoA heuristic,200,150,0.0037688442211055275,0.00028820009902119637,50,91
MMG,200,150,0.0037688442211055275,0.00809870008379221,50,91
SoA heuristic,400,300,0.0018796992481203006,0.00019190018065273762,100,215
MMG,400,300,0.0018796992481203006,0.020671399775892496,100,215
SoA heuristic,600,450,0.0012520868113522537,0.0002816000487655401,150,285
MMG,600,450,0.0012520868113522537,0.024443899979814887,150,285
SoA heuristic,1000,750,0.0007507507507507507,0.0013194000348448753,250,493
MMG,1000,750,0.0007507507507507507,0.09824230009689927,250,493
SoA heuristic,2000,1500,0.00037518759379689845,0.0014881999231874943,500,1005
MMG,2000,1500,0.00037518759379689845,0.38348480011336505,500,1005
SoA heuristic,4000,3000,0.00018754688672168043,0.0026956999208778143,1000,2027
MMG,4000,3000,0.00018754688672168043,1.6105927999597043,1000,2027
SoA heuristic,8000,6000,9.376172021502688e-05,0.05584699986502528,2000,3933
MMG,8000,6000,9.376172021502688e-05,6.319993400014937,2000,3933
SoA heuristic,20,15,0.039473684210526314,7.750000804662704e-05,5,9
MMG,20,15,0.039473684210526314,0.00028980011120438576,5,9
SoA heuristic,40,30,0.019230769230769232,0.00013299984857439995,10,25
MMG,40,30,0.019230769230769232,0.0008578000124543905,10,25
SoA heuristic,100,75,0.007575757575757576,0.0002568999771028757,25,64
MMG,100,75,0.007575757575757576,0.0028876999858766794,25,64
SoA heuristic,200,150,0.0037688442211055275,0.00032890005968511105,50,99
MMG,200,150,0.0037688442211055275,0.010213600005954504,50,99
SoA heuristic,400,300,0.0018796992481203006,0.0006687999702990055,100,207
MMG,400,300,0.0018796992481203006,0.03725540009327233,100,207
SoA heuristic,600,450,0.0012520868113522537,0.0014138000551611185,150,336
MMG,600,450,0.0012520868113522537,0.08297850005328655,150,336
SoA heuristic,1000,750,0.0007507507507507507,0.0021526999771595,250,511
MMG,1000,750,0.0007507507507507507,0.22385080019012094,250,511
SoA heuristic,2000,1500,0.00037518759379689845,0.0041571001056581736,500,1030
MMG,2000,1500,0.00037518759379689845,0.8705163998529315,500,1030
SoA heuristic,4000,3000,0.00018754688672168043,0.006992600159719586,1000,2066
MMG,4000,3000,0.00018754688672168043,3.699050899827853,1000,2066
SoA heuristic,8000,6000,9.376172021502688e-05,0.01682520005851984,2000,4063
MMG,8000,6000,9.376172021502688e-05,17.398052799981087,2000,4063
SoA heuristic,20,15,0.039473684210526314,0.00010529998689889908,5,11
MMG,20,15,0.039473684210526314,0.0005139000713825226,5,11
SoA heuristic,40,30,0.019230769230769232,0.00010180007666349411,10,17
MMG,40,30,0.019230769230769232,0.0012098001316189766,10,17
SoA heuristic,100,75,0.007575757575757576,0.00028460007160902023,25,48
MMG,100,75,0.007575757575757576,0.002971000038087368,25,48
SoA heuristic,200,150,0.0037688442211055275,0.00033769989386200905,50,127
MMG,200,150,0.0037688442211055275,0.010200799908488989,50,127
SoA heuristic,400,300,0.0018796992481203006,0.0007130999583750963,100,228
MMG,400,300,0.0018796992481203006,0.03718130011111498,100,228
SoA heuristic,600,450,0.0012520868113522537,0.0009419999551028013,150,334
MMG,600,450,0.0012520868113522537,0.08157919999212027,150,334
SoA heuristic,1000,750,0.0007507507507507507,0.001309000188484788,250,510
MMG,1000,750,0.0007507507507507507,0.22025330015458167,250,510
SoA heuristic,2000,1500,0.00037518759379689845,0.0033952000085264444,500,988
MMG,2000,1500,0.00037518759379689845,0.8934379999991506,500,988
SoA heuristic,4000,3000,0.00018754688672168043,0.008476299932226539,1000,2010
MMG,4000,3000,0.00018754688672168043,3.7310303000267595,1000,2010
SoA heuristic,8000,6000,9.376172021502688e-05,0.07561379997059703,2000,3978
MMG,8000,6000,9.376172021502688e-05,14.745221300050616,2000,3978
SoA heuristic,20,15,0.039473684210526314,3.050011582672596e-05,5,9
MMG,20,15,0.039473684210526314,9.849993512034416e-05,5,9
SoA heuristic,40,30,0.019230769230769232,3.3300137147307396e-05,10,17
MMG,40,30,0.019230769230769232,0.0002234000712633133,10,17
SoA heuristic,100,75,0.007575757575757576,6.16998877376318e-05,25,38
MMG,100,75,0.007575757575757576,0.0009661999065428972,25,38
SoA heuristic,200,150,0.0037688442211055275,0.00010750000365078449,50,106
MMG,200,150,0.0037688442211055275,0.0031504000071436167,50,106
SoA heuristic,400,300,0.0018796992481203006,0.00022149994038045406,100,178
MMG,400,300,0.0018796992481203006,0.012624999973922968,100,178
SoA heuristic,600,450,0.0012520868113522537,0.00030710012651979923,150,311
MMG,600,450,0.0012520868113522537,0.026521200081333518,150,311
SoA heuristic,1000,750,0.0007507507507507507,0.0005852999165654182,250,506
MMG,1000,750,0.0007507507507507507,0.07423330005258322,250,506
SoA heuristic,2000,1500,0.00037518759379689845,0.001167000038549304,500,1035
MMG,2000,1500,0.00037518759379689845,0.28675640001893044,500,1035
SoA heuristic,4000,3000,0.00018754688672168043,0.0023672999814152718,1000,1992
MMG,4000,3000,0.00018754688672168043,1.1802156001795083,1000,1992
SoA heuristic,8000,6000,9.376172021502688e-05,0.005823399871587753,2000,3995
MMG,8000,6000,9.376172021502688e-05,4.611332100117579,2000,3995
SoA heuristic,20,15,0.039473684210526314,3.220001235604286e-05,5,16
MMG,20,15,0.039473684210526314,0.00010300008580088615,5,16
SoA heuristic,40,30,0.019230769230769232,5.150004290044308e-05,10,16
MMG,40,30,0.019230769230769232,0.00027089985087513924,10,16
SoA heuristic,100,75,0.007575757575757576,6.150011904537678e-05,25,40
MMG,100,75,0.007575757575757576,0.0009354001376777887,25,40
SoA heuristic,200,150,0.0037688442211055275,0.00011010002344846725,50,98
MMG,200,150,0.0037688442211055275,0.003264700062572956,50,98
SoA heuristic,400,300,0.0018796992481203006,0.00021199998445808887,100,191
MMG,400,300,0.0018796992481203006,0.01211949996650219,100,191
SoA heuristic,600,450,0.0012520868113522537,0.00031869998201727867,150,313
MMG,600,450,0.0012520868113522537,0.02662559994496405,150,313
SoA heuristic,1000,750,0.0007507507507507507,0.0005924999713897705,250,504
MMG,1000,750,0.0007507507507507507,0.0729951998218894,250,504
SoA heuristic,2000,1500,0.00037518759379689845,0.0011638998985290527,500,996
MMG,2000,1500,0.00037518759379689845,0.2901628001127392,500,996
SoA heuristic,4000,3000,0.00018754688672168043,0.0024111000820994377,1000,1968
MMG,4000,3000,0.00018754688672168043,1.2006812999024987,1000,1968
SoA heuristic,8000,6000,9.376172021502688e-05,0.00599490012973547,2000,4000
MMG,8000,6000,9.376172021502688e-05,4.7926744997967035,2000,4000
SoA heuristic,20,15,0.039473684210526314,3.809994086623192e-05,5,6
MMG,20,15,0.039473684210526314,0.00013369997031986713,5,6
SoA heuristic,40,30,0.019230769230769232,4.2800093069672585e-05,10,23
MMG,40,30,0.019230769230769232,0.0003130999393761158,10,23
SoA heuristic,100,75,0.007575757575757576,8.25999304652214e-05,25,51
MMG,100,75,0.007575757575757576,0.0012581998016685247,25,51
SoA heuristic,200,150,0.0037688442211055275,0.00014839996583759785,50,90
MMG,200,150,0.0037688442211055275,0.0031846000347286463,50,90
SoA heuristic,400,300,0.0018796992481203006,0.00024429988116025925,100,190
MMG,400,300,0.0018796992481203006,0.011004000203683972,100,190
SoA heuristic,600,450,0.0012520868113522537,0.00030640000477433205,150,278
MMG,600,450,0.0012520868113522537,0.02570439991541207,150,278
SoA heuristic,1000,750,0.0007507507507507507,0.0005878000520169735,250,531
MMG,1000,750,0.0007507507507507507,0.07197589986026287,250,531
SoA heuristic,2000,1500,0.00037518759379689845,0.0011468001175671816,500,979
MMG,2000,1500,0.00037518759379689845,0.28801249992102385,500,979
SoA heuristic,4000,3000,0.00018754688672168043,0.0022956000175327063,1000,2019
MMG,4000,3000,0.00018754688672168043,1.1849601999856532,1000,2019
SoA heuristic,8000,6000,9.376172021502688e-05,0.005021699937060475,2000,3909
MMG,8000,6000,9.376172021502688e-05,4.853321100119501,2000,3909
SoA heuristic,20,15,0.039473684210526314,6.13001175224781e-05,5,7
MMG,20,15,0.039473684210526314,0.00013349996879696846,5,7
SoA heuristic,40,30,0.019230769230769232,4.4899992644786835e-05,10,21
MMG,40,30,0.019230769230769232,0.00030630012042820454,10,21
SoA heuristic,100,75,0.007575757575757576,8.230004459619522e-05,25,51
MMG,100,75,0.007575757575757576,0.0008967001922428608,25,51
SoA heuristic,200,150,0.0037688442211055275,0.00010439986363053322,50,94
MMG,200,150,0.0037688442211055275,0.0030896998941898346,50,94
SoA heuristic,400,300,0.0018796992481203006,0.0002796999178826809,100,184
MMG,400,300,0.0018796992481203006,0.011910300003364682,100,184
SoA heuristic,600,450,0.0012520868113522537,0.00039139995351433754,150,300
MMG,600,450,0.0012520868113522537,0.02478539990261197,150,300
SoA heuristic,1000,750,0.0007507507507507507,0.0006355000659823418,250,479
MMG,1000,750,0.0007507507507507507,0.06967400014400482,250,479
SoA heuristic,2000,1500,0.00037518759379689845,0.0011094000656157732,500,1027
MMG,2000,1500,0.00037518759379689845,0.2846178999170661,500,1027
SoA heuristic,4000,3000,0.00018754688672168043,0.0023961998522281647,1000,1957
MMG,4000,3000,0.00018754688672168043,1.1574285998940468,1000,1957
SoA heuristic,8000,6000,9.376172021502688e-05,0.0048865999560803175,2000,4022
MMG,8000,6000,9.376172021502688e-05,4.761316399788484,2000,4022
SoA heuristic,20,15,0.039473684210526314,3.0800001695752144e-05,5,8
MMG,20,15,0.039473684210526314,0.00010269996710121632,5,8
SoA heuristic,40,30,0.019230769230769232,3.560003824532032e-05,10,32
MMG,40,30,0.019230769230769232,0.000238100066781044,10,32
SoA heuristic,100,75,0.007575757575757576,9.190011769533157e-05,25,53
MMG,100,75,0.007575757575757576,0.0009343998972326517,25,53
SoA heuristic,200,150,0.0037688442211055275,0.00011160015128552914,50,108
MMG,200,150,0.0037688442211055275,0.0033258998300880194,50,108
SoA heuristic,400,300,0.0018796992481203006,0.00020919996313750744,100,215
MMG,400,300,0.0018796992481203006,0.012051299912855029,100,215
SoA heuristic,600,450,0.0012520868113522537,0.00032739993184804916,150,312
MMG,600,450,0.0012520868113522537,0.02708670007996261,150,312
SoA heuristic,1000,750,0.0007507507507507507,0.0005985000170767307,250,520
MMG,1000,750,0.0007507507507507507,0.07224639994092286,250,520
SoA heuristic,2000,1500,0.00037518759379689845,0.0011676999274641275,500,1009
MMG,2000,1500,0.00037518759379689845,0.28980759996920824,500,1009
SoA heuristic,4000,3000,0.00018754688672168043,0.0023363002110272646,1000,2062
MMG,4000,3000,0.00018754688672168043,1.1926186999771744,1000,2062
SoA heuristic,8000,6000,9.376172021502688e-05,0.006082399981096387,2000,4011
MMG,8000,6000,9.376172021502688e-05,4.909517099848017,2000,4011
SoA heuristic,20,15,0.039473684210526314,3.7400051951408386e-05,5,8
MMG,20,15,0.039473684210526314,0.0001349998638033867,5,8
SoA heuristic,40,30,0.019230769230769232,4.970002919435501e-05,10,24
MMG,40,30,0.019230769230769232,0.000313800061121583,10,24
SoA heuristic,100,75,0.007575757575757576,8.639995940029621e-05,25,46
MMG,100,75,0.007575757575757576,0.0012731999158859253,25,46
SoA heuristic,200,150,0.0037688442211055275,0.00014899997040629387,50,101
MMG,200,150,0.0037688442211055275,0.0033319001086056232,50,101
SoA heuristic,400,300,0.0018796992481203006,0.0002796999178826809,100,225
MMG,400,300,0.0018796992481203006,0.011726299999281764,100,225
SoA heuristic,600,450,0.0012520868113522537,0.0003062998875975609,150,354
MMG,600,450,0.0012520868113522537,0.0244697998277843,150,354
SoA heuristic,1000,750,0.0007507507507507507,0.0006895000115036964,250,479
MMG,1000,750,0.0007507507507507507,0.0687905999366194,250,479
SoA heuristic,2000,1500,0.00037518759379689845,0.0011487998999655247,500,1017
MMG,2000,1500,0.00037518759379689845,0.2874509999528527,500,1017
SoA heuristic,4000,3000,0.00018754688672168043,0.0023630999494343996,1000,1996
MMG,4000,3000,0.00018754688672168043,1.1809050999581814,1000,1996
SoA heuristic,8000,6000,9.376172021502688e-05,0.005697899963706732,2000,3909
MMG,8000,6000,9.376172021502688e-05,4.756244600052014,2000,3909
SoA heuristic,20,15,0.039473684210526314,2.9399991035461426e-05,5,5
MMG,20,15,0.039473684210526314,9.860005229711533e-05,5,5
SoA heuristic,40,30,0.019230769230769232,3.7599820643663406e-05,10,20
MMG,40,30,0.019230769230769232,0.0002296001184731722,10,20
SoA heuristic,100,75,0.007575757575757576,6.029987707734108e-05,25,50
MMG,100,75,0.007575757575757576,0.0009400001727044582,25,50
SoA heuristic,200,150,0.0037688442211055275,0.0001097000204026699,50,89
MMG,200,150,0.0037688442211055275,0.0032967000734061003,50,89
SoA heuristic,400,300,0.0018796992481203006,0.00020839995704591274,100,203
MMG,400,300,0.0018796992481203006,0.012219900032505393,100,203
SoA heuristic,600,450,0.0012520868113522537,0.00033059995621442795,150,292
MMG,600,450,0.0012520868113522537,0.026719999965280294,150,292
SoA heuristic,1000,750,0.0007507507507507507,0.0005864999257028103,250,523
MMG,1000,750,0.0007507507507507507,0.07218859996646643,250,523
SoA heuristic,2000,1500,0.00037518759379689845,0.0013535001780837774,500,1015
MMG,2000,1500,0.00037518759379689845,0.28740080003626645,500,1015
SoA heuristic,4000,3000,0.00018754688672168043,0.0023603998124599457,1000,2000
MMG,4000,3000,0.00018754688672168043,1.204645600169897,1000,2000
SoA heuristic,8000,6000,9.376172021502688e-05,0.038839199813082814,2000,4017
MMG,8000,6000,9.376172021502688e-05,4.871393699897453,2000,4017
SoA heuristic,20,15,0.039473684210526314,3.050011582672596e-05,5,8
MMG,20,15,0.039473684210526314,0.00010020006448030472,5,8
SoA heuristic,40,30,0.019230769230769232,3.3899908885359764e-05,10,23
MMG,40,30,0.019230769230769232,0.00022869999520480633,10,23
SoA heuristic,100,75,0.007575757575757576,6.120000034570694e-05,25,52
MMG,100,75,0.007575757575757576,0.0009703999385237694,25,52
SoA heuristic,200,150,0.0037688442211055275,0.00011119991540908813,50,115
MMG,200,150,0.0037688442211055275,0.003316099988296628,50,115
SoA heuristic,400,300,0.0018796992481203006,0.00022990000434219837,100,207
MMG,400,300,0.0018796992481203006,0.012033300008624792,100,207
SoA heuristic,600,450,0.0012520868113522537,0.0003060998860746622,150,298
MMG,600,450,0.0012520868113522537,0.026630300097167492,150,298
SoA heuristic,1000,750,0.0007507507507507507,0.0007224997971206903,250,488
MMG,1000,750,0.0007507507507507507,0.07371239992789924,250,488
SoA heuristic,2000,1500,0.00037518759379689845,0.0013840000610798597,500,1000
MMG,2000,1500,0.00037518759379689845,0.2895509998779744,500,1000
SoA heuristic,4000,3000,0.00018754688672168043,0.0023940999526530504,1000,1976
MMG,4000,3000,0.00018754688672168043,1.1888776998966932,1000,1976
SoA heuristic,8000,6000,9.376172021502688e-05,0.03518030000850558,2000,3990
MMG,8000,6000,9.376172021502688e-05,4.8396759000606835,2000,3990
SoA heuristic,20,15,0.039473684210526314,3.0899886041879654e-05,5,10
MMG,20,15,0.039473684210526314,0.00011060014367103577,5,10
SoA heuristic,40,30,0.019230769230769232,3.50000336766243e-05,10,17
MMG,40,30,0.019230769230769232,0.00023399991914629936,10,17
SoA heuristic,100,75,0.007575757575757576,6.08998816460371e-05,25,40
MMG,100,75,0.007575757575757576,0.0009537001606076956,25,40
SoA heuristic,200,150,0.0037688442211055275,0.00011730007827281952,50,97
MMG,200,150,0.0037688442211055275,0.003251400077715516,50,97
SoA heuristic,400,300,0.0018796992481203006,0.00021910015493631363,100,202
MMG,400,300,0.0018796992481203006,0.012004700023680925,100,202
SoA heuristic,600,450,0.0012520868113522537,0.0003309999592602253,150,300
MMG,600,450,0.0012520868113522537,0.027085999958217144,150,300
SoA heuristic,1000,750,0.0007507507507507507,0.0006033999379724264,250,511
MMG,1000,750,0.0007507507507507507,0.07305600005201995,250,511
SoA heuristic,2000,1500,0.00037518759379689845,0.001160199986770749,500,1023
MMG,2000,1500,0.00037518759379689845,0.28978090011514723,500,1023
SoA heuristic,4000,3000,0.00018754688672168043,0.002369499998167157,1000,2005
MMG,4000,3000,0.00018754688672168043,1.1962776000145823,1000,2005
SoA heuristic,8000,6000,9.376172021502688e-05,0.005728899966925383,2000,3875
MMG,8000,6000,9.376172021502688e-05,4.791849399916828,2000,3875
SoA heuristic,20,15,0.039473684210526314,3.800005652010441e-05,5,12
MMG,20,15,0.039473684210526314,0.0001338999718427658,5,12
SoA heuristic,40,30,0.019230769230769232,4.529999569058418e-05,10,19
MMG,40,30,0.019230769230769232,0.00031219981610774994,10,19
SoA heuristic,100,75,0.007575757575757576,8.199992589652538e-05,25,52
MMG,100,75,0.007575757575757576,0.0011813999153673649,25,52
SoA heuristic,200,150,0.0037688442211055275,0.0001324999611824751,50,102
MMG,200,150,0.0037688442211055275,0.0032562999986112118,50,102
SoA heuristic,400,300,0.0018796992481203006,0.00019030016846954823,100,200
MMG,400,300,0.0018796992481203006,0.011314800009131432,100,200
SoA heuristic,600,450,0.0012520868113522537,0.0003160999622195959,150,276
MMG,600,450,0.0012520868113522537,0.026104599935933948,150,276
SoA heuristic,1000,750,0.0007507507507507507,0.0006002001464366913,250,512
MMG,1000,750,0.0007507507507507507,0.07280580000951886,250,512
SoA heuristic,2000,1500,0.00037518759379689845,0.0012296000495553017,500,1002
MMG,2000,1500,0.00037518759379689845,0.3029763998929411,500,1002
SoA heuristic,4000,3000,0.00018754688672168043,0.002253699814900756,1000,1994
MMG,4000,3000,0.00018754688672168043,1.2816466998774558,1000,1994
SoA heuristic,8000,6000,9.376172021502688e-05,0.005470799980685115,2000,3960
MMG,8000,6000,9.376172021502688e-05,5.3118042999412864,2000,3960
